á#beira#da	á#beira#de+a	S+GFS	I
á#beira#dalgún	á#beira#de+algún	S+IMS0	I
á#beira#dalgúns	á#beira#de+algúns	S+IMP0	I
á#beira#dalgunha	á#beira#de+algunha	S+IFS0	I
á#beira#dalgunhas	á#beira#de+algunhas	S+IFP0	I
á#beira#daquel	á#beira#de+aquel	S+DMS	I
á#beira#daquela	á#beira#de+aquela	S+DFS	I
á#beira#daquelas	á#beira#de+aquelas	S+DFP	I
á#beira#daqueles	á#beira#de+aqueles	S+DMP	I
á#beira#daqueloutra	á#beira#de+aquela+outra	S+DFS+IFS0	I
á#beira#daqueloutras	á#beira#de+aquelas+outras	S+DFP+IFP0	I
á#beira#daqueloutro	á#beira#de+aquel+outro	S+DMS+IMS0	I
á#beira#daqueloutros	á#beira#de+aqueles+outros	S+DMP+IMP0	I
á#beira#daquilo	á#beira#de+aquilo	S+DNS	I
á#beira#das	á#beira#de+as	S+GFP	I
á#beira#de	á#beira#de	S	I
á#beira#del	á#beira#de+el	S+P3MSB0	I
á#beira#dela	á#beira#de+ela	S+P3FSB0	I
á#beira#delas	á#beira#de+elas	S+P3FPB0	I
á#beira#deles	á#beira#de+eles	S+P3MPB0	I
á#beira#desa	á#beira#de+esa	S+DFS	I
á#beira#desas	á#beira#de+esas	S+DFP	I
á#beira#dese	á#beira#de+ese	S+DMS	I
á#beira#deses	á#beira#de+eses	S+DMP	I
á#beira#desoutra	á#beira#de+esa+outra	S+DFS+IFS0	I
á#beira#desoutras	á#beira#de+esas+outras	S+DFP+IFP0	I
á#beira#desoutro	á#beira#de+ese+outro	S+DMS+IMS0	I
á#beira#desoutros	á#beira#de+eses+outros	S+DMP+IMP0	I
á#beira#desta	á#beira#de+esta	S+DFS	I
á#beira#destas	á#beira#de+estas	S+DFP	I
á#beira#deste	á#beira#de+este	S+DMS	I
á#beira#destes	á#beira#de+estes	S+DMP	I
á#beira#destoutra	á#beira#de+esta+outra	S+DFS+IFS0	I
á#beira#destoutras	á#beira#de+estas+outras	S+DFP+IFP0	I
á#beira#destoutro	á#beira#de+este+outro	S+DMS+IMS0	I
á#beira#destoutros	á#beira#de+estes+outros	S+DMP+IMP0	I
á#beira#diso	á#beira#de+iso	S+DNS	I
á#beira#disto	á#beira#de+isto	S+DNS	I
á#beira#do	á#beira#de+o	S+GMS	I
á#beira#dos	á#beira#de+os	S+GMP	I
á#beira#doutra	á#beira#de+outra	S+IFS0	I
á#beira#doutras	á#beira#de+outras	S+IFP0	I
á#beira#doutro	á#beira#de+outro	S+IMS0	I
á#beira#doutros	á#beira#de+outros	S+IMP0	I
á#beira#dun	á#beira#de+un	S+IMS0	I
á#beira#dunha	á#beira#de+unha	S+IFS0	I
á#beira#dunhas	á#beira#de+unhas	S+IFP0	I
á#beira#duns	á#beira#de+uns	S+IMP0	I
á#parte#da	á#parte#de+a	S+GFS	I
á#parte#dalgún	á#parte#de+algún	S+IMS0	I
á#parte#dalgúns	á#parte#de+algúns	S+IMP0	I
á#parte#dalgunha	á#parte#de+algunha	S+IFS0	I
á#parte#dalgunhas	á#parte#de+algunhas	S+IFP0	I
á#parte#daquel	á#parte#de+aquel	S+DMS	I
á#parte#daquela	á#parte#de+aquela	S+DFS	I
á#parte#daquelas	á#parte#de+aquelas	S+DFP	I
á#parte#daqueles	á#parte#de+aqueles	S+DMP	I
á#parte#daqueloutra	á#parte#de+aquela+outra	S+DFS+IFS0	I
á#parte#daqueloutras	á#parte#de+aquelas+outras	S+DFP+IFP0	I
á#parte#daqueloutro	á#parte#de+aquel+outro	S+DMS+IMS0	I
á#parte#daqueloutros	á#parte#de+aqueles+outros	S+DMP+IMP0	I
á#parte#daquilo	á#parte#de+aquilo	S+DNS	I
á#parte#das	á#parte#de+as	S+GFP	I
á#parte#de	á#parte#de	S	I
á#parte#del	á#parte#de+el	S+P3MSB0	I
á#parte#dela	á#parte#de+ela	S+P3FSB0	I
á#parte#delas	á#parte#de+elas	S+P3FPB0	I
á#parte#deles	á#parte#de+eles	S+P3MPB0	I
á#parte#desa	á#parte#de+esa	S+DFS	I
á#parte#desas	á#parte#de+esas	S+DFP	I
á#parte#dese	á#parte#de+ese	S+DMS	I
á#parte#deses	á#parte#de+eses	S+DMP	I
á#parte#desoutra	á#parte#de+esa+outra	S+DFS+IFS0	I
á#parte#desoutras	á#parte#de+esas+outras	S+DFP+IFP0	I
á#parte#desoutro	á#parte#de+ese+outro	S+DMS+IMS0	I
á#parte#desoutros	á#parte#de+eses+outros	S+DMP+IMP0	I
á#parte#desta	á#parte#de+esta	S+DFS	I
á#parte#destas	á#parte#de+estas	S+DFP	I
á#parte#deste	á#parte#de+este	S+DMS	I
á#parte#destes	á#parte#de+estes	S+DMP	I
á#parte#destoutra	á#parte#de+esta+outra	S+DFS+IFS0	I
á#parte#destoutras	á#parte#de+estas+outras	S+DFP+IFP0	I
á#parte#destoutro	á#parte#de+este+outro	S+DMS+IMS0	I
á#parte#destoutros	á#parte#de+estes+outros	S+DMP+IMP0	I
á#parte#diso	á#parte#de+iso	S+DNS	I
á#parte#disto	á#parte#de+isto	S+DNS	I
á#parte#do	á#parte#de+o	S+GMS	I
á#parte#dos	á#parte#de+os	S+GMP	I
á#parte#doutra	á#parte#de+outra	S+IFS0	I
á#parte#doutras	á#parte#de+outras	S+IFP0	I
á#parte#doutro	á#parte#de+outro	S+IMS0	I
á#parte#doutros	á#parte#de+outros	S+IMP0	I
á#parte#dun	á#parte#de+un	S+IMS0	I
á#parte#dunha	á#parte#de+unha	S+IFS0	I
á#parte#dunhas	á#parte#de+unhas	S+IFP0	I
á#parte#duns	á#parte#de+uns	S+IMP0	I
ó#lado#da	ó#lado#de+a	S+GFS	I
ó#lado#dalgún	ó#lado#de+algún	S+IMS0	I
ó#lado#dalgúns	ó#lado#de+algúns	S+IMP0	I
ó#lado#dalgunha	ó#lado#de+algunha	S+IFS0	I
ó#lado#dalgunhas	ó#lado#de+algunhas	S+IFP0	I
ó#lado#daquel	ó#lado#de+aquel	S+DMS	I
ó#lado#daquela	ó#lado#de+aquela	S+DFS	I
ó#lado#daquelas	ó#lado#de+aquelas	S+DFP	I
ó#lado#daqueles	ó#lado#de+aqueles	S+DMP	I
ó#lado#daqueloutra	ó#lado#de+aquela+outra	S+DFS+IFS0	I
ó#lado#daqueloutras	ó#lado#de+aquelas+outras	S+DFP+IFP0	I
ó#lado#daqueloutro	ó#lado#de+aquel+outro	S+DMS+IMS0	I
ó#lado#daqueloutros	ó#lado#de+aqueles+outros	S+DMP+IMP0	I
ó#lado#daquilo	ó#lado#de+aquilo	S+DNS	I
ó#lado#das	ó#lado#de+as	S+GFP	I
ó#lado#de	ó#lado#de	S	I
ó#lado#del	ó#lado#de+el	S+P3MSB0	I
ó#lado#dela	ó#lado#de+ela	S+P3FSB0	I
ó#lado#delas	ó#lado#de+elas	S+P3FPB0	I
ó#lado#deles	ó#lado#de+eles	S+P3MPB0	I
ó#lado#desa	ó#lado#de+esa	S+DFS	I
ó#lado#desas	ó#lado#de+esas	S+DFP	I
ó#lado#dese	ó#lado#de+ese	S+DMS	I
ó#lado#deses	ó#lado#de+eses	S+DMP	I
ó#lado#desoutra	ó#lado#de+esa+outra	S+DFS+IFS0	I
ó#lado#desoutras	ó#lado#de+esas+outras	S+DFP+IFP0	I
ó#lado#desoutro	ó#lado#de+ese+outro	S+DMS+IMS0	I
ó#lado#desoutros	ó#lado#de+eses+outros	S+DMP+IMP0	I
ó#lado#desta	ó#lado#de+esta	S+DFS	I
ó#lado#destas	ó#lado#de+estas	S+DFP	I
ó#lado#deste	ó#lado#de+este	S+DMS	I
ó#lado#destes	ó#lado#de+estes	S+DMP	I
ó#lado#destoutra	ó#lado#de+esta+outra	S+DFS+IFS0	I
ó#lado#destoutras	ó#lado#de+estas+outras	S+DFP+IFP0	I
ó#lado#destoutro	ó#lado#de+este+outro	S+DMS+IMS0	I
ó#lado#destoutros	ó#lado#de+estes+outros	S+DMP+IMP0	I
ó#lado#diso	ó#lado#de+iso	S+DNS	I
ó#lado#disto	ó#lado#de+isto	S+DNS	I
ó#lado#do	ó#lado#de+o	S+GMS	I
ó#lado#dos	ó#lado#de+os	S+GMP	I
ó#lado#doutra	ó#lado#de+outra	S+IFS0	I
ó#lado#doutras	ó#lado#de+outras	S+IFP0	I
ó#lado#doutro	ó#lado#de+outro	S+IMS0	I
ó#lado#doutros	ó#lado#de+outros	S+IMP0	I
ó#lado#dun	ó#lado#de+un	S+IMS0	I
ó#lado#dunha	ó#lado#de+unha	S+IFS0	I
ó#lado#dunhas	ó#lado#de+unhas	S+IFP0	I
ó#lado#duns	ó#lado#de+uns	S+IMP0	I
ó#pé#da	ó#pé#de+a	S+GFS	I
ó#pé#dalgún	ó#pé#de+algún	S+IMS0	I
ó#pé#dalgúns	ó#pé#de+algúns	S+IMP0	I
ó#pé#dalgunha	ó#pé#de+algunha	S+IFS0	I
ó#pé#dalgunhas	ó#pé#de+algunhas	S+IFP0	I
ó#pé#daquel	ó#pé#de+aquel	S+DMS	I
ó#pé#daquela	ó#pé#de+aquela	S+DFS	I
ó#pé#daquelas	ó#pé#de+aquelas	S+DFP	I
ó#pé#daqueles	ó#pé#de+aqueles	S+DMP	I
ó#pé#daqueloutra	ó#pé#de+aquela+outra	S+DFS+IFS0	I
ó#pé#daqueloutras	ó#pé#de+aquelas+outras	S+DFP+IFP0	I
ó#pé#daqueloutro	ó#pé#de+aquel+outro	S+DMS+IMS0	I
ó#pé#daqueloutros	ó#pé#de+aqueles+outros	S+DMP+IMP0	I
ó#pé#daquilo	ó#pé#de+aquilo	S+DNS	I
ó#pé#das	ó#pé#de+as	S+GFP	I
ó#pé#de	ó#pé#de	S	I
ó#pé#del	ó#pé#de+el	S+P3MSB0	I
ó#pé#dela	ó#pé#de+ela	S+P3FSB0	I
ó#pé#delas	ó#pé#de+elas	S+P3FPB0	I
ó#pé#deles	ó#pé#de+eles	S+P3MPB0	I
ó#pé#desa	ó#pé#de+esa	S+DFS	I
ó#pé#desas	ó#pé#de+esas	S+DFP	I
ó#pé#dese	ó#pé#de+ese	S+DMS	I
ó#pé#deses	ó#pé#de+eses	S+DMP	I
ó#pé#desoutra	ó#pé#de+esa+outra	S+DFS+IFS0	I
ó#pé#desoutras	ó#pé#de+esas+outras	S+DFP+IFP0	I
ó#pé#desoutro	ó#pé#de+ese+outro	S+DMS+IMS0	I
ó#pé#desoutros	ó#pé#de+eses+outros	S+DMP+IMP0	I
ó#pé#desta	ó#pé#de+esta	S+DFS	I
ó#pé#destas	ó#pé#de+estas	S+DFP	I
ó#pé#deste	ó#pé#de+este	S+DMS	I
ó#pé#destes	ó#pé#de+estes	S+DMP	I
ó#pé#destoutra	ó#pé#de+esta+outra	S+DFS+IFS0	I
ó#pé#destoutras	ó#pé#de+estas+outras	S+DFP+IFP0	I
ó#pé#destoutro	ó#pé#de+este+outro	S+DMS+IMS0	I
ó#pé#destoutros	ó#pé#de+estes+outros	S+DMP+IMP0	I
ó#pé#diso	ó#pé#de+iso	S+DNS	I
ó#pé#disto	ó#pé#de+isto	S+DNS	I
ó#pé#do	ó#pé#de+o	S+GMS	I
ó#pé#dos	ó#pé#de+os	S+GMP	I
ó#pé#doutra	ó#pé#de+outra	S+IFS0	I
ó#pé#doutras	ó#pé#de+outras	S+IFP0	I
ó#pé#doutro	ó#pé#de+outro	S+IMS0	I
ó#pé#doutros	ó#pé#de+outros	S+IMP0	I
ó#pé#dun	ó#pé#de+un	S+IMS0	I
ó#pé#dunha	ó#pé#de+unha	S+IFS0	I
ó#pé#dunhas	ó#pé#de+unhas	S+IFP0	I
ó#pé#duns	ó#pé#de+uns	S+IMP0	I
ó#par#da	ó#par#de+a	S+GFS	I
ó#par#dalgún	ó#par#de+algún	S+IMS0	I
ó#par#dalgúns	ó#par#de+algúns	S+IMP0	I
ó#par#dalgunha	ó#par#de+algunha	S+IFS0	I
ó#par#dalgunhas	ó#par#de+algunhas	S+IFP0	I
ó#par#daquel	ó#par#de+aquel	S+DMS	I
ó#par#daquela	ó#par#de+aquela	S+DFS	I
ó#par#daquelas	ó#par#de+aquelas	S+DFP	I
ó#par#daqueles	ó#par#de+aqueles	S+DMP	I
ó#par#daqueloutra	ó#par#de+aquela+outra	S+DFS+IFS0	I
ó#par#daqueloutras	ó#par#de+aquelas+outras	S+DFP+IFP0	I
ó#par#daqueloutro	ó#par#de+aquel+outro	S+DMS+IMS0	I
ó#par#daqueloutros	ó#par#de+aqueles+outros	S+DMP+IMP0	I
ó#par#daquilo	ó#par#de+aquilo	S+DNS	I
ó#par#das	ó#par#de+as	S+GFP	I
ó#par#de	ó#par#de	S	I
ó#par#del	ó#par#de+el	S+P3MSB0	I
ó#par#dela	ó#par#de+ela	S+P3FSB0	I
ó#par#delas	ó#par#de+elas	S+P3FPB0	I
ó#par#deles	ó#par#de+eles	S+P3MPB0	I
ó#par#desa	ó#par#de+esa	S+DFS	I
ó#par#desas	ó#par#de+esas	S+DFP	I
ó#par#dese	ó#par#de+ese	S+DMS	I
ó#par#deses	ó#par#de+eses	S+DMP	I
ó#par#desoutra	ó#par#de+esa+outra	S+DFS+IFS0	I
ó#par#desoutras	ó#par#de+esas+outras	S+DFP+IFP0	I
ó#par#desoutro	ó#par#de+ese+outro	S+DMS+IMS0	I
ó#par#desoutros	ó#par#de+eses+outros	S+DMP+IMP0	I
ó#par#desta	ó#par#de+esta	S+DFS	I
ó#par#destas	ó#par#de+estas	S+DFP	I
ó#par#deste	ó#par#de+este	S+DMS	I
ó#par#destes	ó#par#de+estes	S+DMP	I
ó#par#destoutra	ó#par#de+esta+outra	S+DFS+IFS0	I
ó#par#destoutras	ó#par#de+estas+outras	S+DFP+IFP0	I
ó#par#destoutro	ó#par#de+este+outro	S+DMS+IMS0	I
ó#par#destoutros	ó#par#de+estes+outros	S+DMP+IMP0	I
ó#par#diso	ó#par#de+iso	S+DNS	I
ó#par#disto	ó#par#de+isto	S+DNS	I
ó#par#do	ó#par#de+o	S+GMS	I
ó#par#dos	ó#par#de+os	S+GMP	I
ó#par#doutra	ó#par#de+outra	S+IFS0	I
ó#par#doutras	ó#par#de+outras	S+IFP0	I
ó#par#doutro	ó#par#de+outro	S+IMS0	I
ó#par#doutros	ó#par#de+outros	S+IMP0	I
ó#par#dun	ó#par#de+un	S+IMS0	I
ó#par#dunha	ó#par#de+unha	S+IFS0	I
ó#par#dunhas	ó#par#de+unhas	S+IFP0	I
ó#par#duns	ó#par#de+uns	S+IMP0	I
ó#redor#da	ó#redor#de+a	S+GFS	I
ó#redor#dalgún	ó#redor#de+algún	S+IMS0	I
ó#redor#dalgúns	ó#redor#de+algúns	S+IMP0	I
ó#redor#dalgunha	ó#redor#de+algunha	S+IFS0	I
ó#redor#dalgunhas	ó#redor#de+algunhas	S+IFP0	I
ó#redor#daquel	ó#redor#de+aquel	S+DMS	I
ó#redor#daquela	ó#redor#de+aquela	S+DFS	I
ó#redor#daquelas	ó#redor#de+aquelas	S+DFP	I
ó#redor#daqueles	ó#redor#de+aqueles	S+DMP	I
ó#redor#daqueloutra	ó#redor#de+aquela+outra	S+DFS+IFS0	I
ó#redor#daqueloutras	ó#redor#de+aquelas+outras	S+DFP+IFP0	I
ó#redor#daqueloutro	ó#redor#de+aquel+outro	S+DMS+IMS0	I
ó#redor#daqueloutros	ó#redor#de+aqueles+outros	S+DMP+IMP0	I
ó#redor#daquilo	ó#redor#de+aquilo	S+DNS	I
ó#redor#das	ó#redor#de+as	S+GFP	I
ó#redor#de	ó#redor#de	S	I
ó#redor#del	ó#redor#de+el	S+P3MSB0	I
ó#redor#dela	ó#redor#de+ela	S+P3FSB0	I
ó#redor#delas	ó#redor#de+elas	S+P3FPB0	I
ó#redor#deles	ó#redor#de+eles	S+P3MPB0	I
ó#redor#desa	ó#redor#de+esa	S+DFS	I
ó#redor#desas	ó#redor#de+esas	S+DFP	I
ó#redor#dese	ó#redor#de+ese	S+DMS	I
ó#redor#deses	ó#redor#de+eses	S+DMP	I
ó#redor#desoutra	ó#redor#de+esa+outra	S+DFS+IFS0	I
ó#redor#desoutras	ó#redor#de+esas+outras	S+DFP+IFP0	I
ó#redor#desoutro	ó#redor#de+ese+outro	S+DMS+IMS0	I
ó#redor#desoutros	ó#redor#de+eses+outros	S+DMP+IMP0	I
ó#redor#desta	ó#redor#de+esta	S+DFS	I
ó#redor#destas	ó#redor#de+estas	S+DFP	I
ó#redor#deste	ó#redor#de+este	S+DMS	I
ó#redor#destes	ó#redor#de+estes	S+DMP	I
ó#redor#destoutra	ó#redor#de+esta+outra	S+DFS+IFS0	I
ó#redor#destoutras	ó#redor#de+estas+outras	S+DFP+IFP0	I
ó#redor#destoutro	ó#redor#de+este+outro	S+DMS+IMS0	I
ó#redor#destoutros	ó#redor#de+estes+outros	S+DMP+IMP0	I
ó#redor#diso	ó#redor#de+iso	S+DNS	I
ó#redor#disto	ó#redor#de+isto	S+DNS	I
ó#redor#do	ó#redor#de+o	S+GMS	I
ó#redor#dos	ó#redor#de+os	S+GMP	I
ó#redor#doutra	ó#redor#de+outra	S+IFS0	I
ó#redor#doutras	ó#redor#de+outras	S+IFP0	I
ó#redor#doutro	ó#redor#de+outro	S+IMS0	I
ó#redor#doutros	ó#redor#de+outros	S+IMP0	I
ó#redor#dun	ó#redor#de+un	S+IMS0	I
ó#redor#dunha	ó#redor#de+unha	S+IFS0	I
ó#redor#dunhas	ó#redor#de+unhas	S+IFP0	I
ó#redor#duns	ó#redor#de+uns	S+IMP0	I
a#carón#da	a#carón#de+a	S+GFS	I
a#carón#dalgún	a#carón#de+algún	S+IMS0	I
a#carón#dalgúns	a#carón#de+algúns	S+IMP0	I
a#carón#dalgunha	a#carón#de+algunha	S+IFS0	I
a#carón#dalgunhas	a#carón#de+algunhas	S+IFP0	I
a#carón#daquel	a#carón#de+aquel	S+DMS	I
a#carón#daquela	a#carón#de+aquela	S+DFS	I
a#carón#daquelas	a#carón#de+aquelas	S+DFP	I
a#carón#daqueles	a#carón#de+aqueles	S+DMP	I
a#carón#daqueloutra	a#carón#de+aquela+outra	S+DFS+IFS0	I
a#carón#daqueloutras	a#carón#de+aquelas+outras	S+DFP+IFP0	I
a#carón#daqueloutro	a#carón#de+aquel+outro	S+DMS+IMS0	I
a#carón#daqueloutros	a#carón#de+aqueles+outros	S+DMP+IMP0	I
a#carón#daquilo	a#carón#de+aquilo	S+DNS	I
a#carón#das	a#carón#de+as	S+GFP	I
a#carón#de	a#carón#de	S	I
a#carón#del	a#carón#de+el	S+P3MSB0	I
a#carón#dela	a#carón#de+ela	S+P3FSB0	I
a#carón#delas	a#carón#de+elas	S+P3FPB0	I
a#carón#deles	a#carón#de+eles	S+P3MPB0	I
a#carón#desa	a#carón#de+esa	S+DFS	I
a#carón#desas	a#carón#de+esas	S+DFP	I
a#carón#dese	a#carón#de+ese	S+DMS	I
a#carón#deses	a#carón#de+eses	S+DMP	I
a#carón#desoutra	a#carón#de+esa+outra	S+DFS+IFS0	I
a#carón#desoutras	a#carón#de+esas+outras	S+DFP+IFP0	I
a#carón#desoutro	a#carón#de+ese+outro	S+DMS+IMS0	I
a#carón#desoutros	a#carón#de+eses+outros	S+DMP+IMP0	I
a#carón#desta	a#carón#de+esta	S+DFS	I
a#carón#destas	a#carón#de+estas	S+DFP	I
a#carón#deste	a#carón#de+este	S+DMS	I
a#carón#destes	a#carón#de+estes	S+DMP	I
a#carón#destoutra	a#carón#de+esta+outra	S+DFS+IFS0	I
a#carón#destoutras	a#carón#de+estas+outras	S+DFP+IFP0	I
a#carón#destoutro	a#carón#de+este+outro	S+DMS+IMS0	I
a#carón#destoutros	a#carón#de+estes+outros	S+DMP+IMP0	I
a#carón#diso	a#carón#de+iso	S+DNS	I
a#carón#disto	a#carón#de+isto	S+DNS	I
a#carón#do	a#carón#de+o	S+GMS	I
a#carón#dos	a#carón#de+os	S+GMP	I
a#carón#doutra	a#carón#de+outra	S+IFS0	I
a#carón#doutras	a#carón#de+outras	S+IFP0	I
a#carón#doutro	a#carón#de+outro	S+IMS0	I
a#carón#doutros	a#carón#de+outros	S+IMP0	I
a#carón#dun	a#carón#de+un	S+IMS0	I
a#carón#dunha	a#carón#de+unha	S+IFS0	I
a#carón#dunhas	a#carón#de+unhas	S+IFP0	I
a#carón#duns	a#carón#de+uns	S+IMP0	I
a#causa#da	a#causa#de+a	S+GFS	I
a#causa#dalgún	a#causa#de+algún	S+IMS0	I
a#causa#dalgúns	a#causa#de+algúns	S+IMP0	I
a#causa#dalgunha	a#causa#de+algunha	S+IFS0	I
a#causa#dalgunhas	a#causa#de+algunhas	S+IFP0	I
a#causa#daquel	a#causa#de+aquel	S+DMS	I
a#causa#daquela	a#causa#de+aquela	S+DFS	I
a#causa#daquelas	a#causa#de+aquelas	S+DFP	I
a#causa#daqueles	a#causa#de+aqueles	S+DMP	I
a#causa#daqueloutra	a#causa#de+aquela+outra	S+DFS+IFS0	I
a#causa#daqueloutras	a#causa#de+aquelas+outras	S+DFP+IFP0	I
a#causa#daqueloutro	a#causa#de+aquel+outro	S+DMS+IMS0	I
a#causa#daqueloutros	a#causa#de+aqueles+outros	S+DMP+IMP0	I
a#causa#daquilo	a#causa#de+aquilo	S+DNS	I
a#causa#das	a#causa#de+as	S+GFP	I
a#causa#de	a#causa#de	S	I
a#causa#del	a#causa#de+el	S+P3MSB0	I
a#causa#dela	a#causa#de+ela	S+P3FSB0	I
a#causa#delas	a#causa#de+elas	S+P3FPB0	I
a#causa#deles	a#causa#de+eles	S+P3MPB0	I
a#causa#desa	a#causa#de+esa	S+DFS	I
a#causa#desas	a#causa#de+esas	S+DFP	I
a#causa#dese	a#causa#de+ese	S+DMS	I
a#causa#deses	a#causa#de+eses	S+DMP	I
a#causa#desoutra	a#causa#de+esa+outra	S+DFS+IFS0	I
a#causa#desoutras	a#causa#de+esas+outras	S+DFP+IFP0	I
a#causa#desoutro	a#causa#de+ese+outro	S+DMS+IMS0	I
a#causa#desoutros	a#causa#de+eses+outros	S+DMP+IMP0	I
a#causa#desta	a#causa#de+esta	S+DFS	I
a#causa#destas	a#causa#de+estas	S+DFP	I
a#causa#deste	a#causa#de+este	S+DMS	I
a#causa#destes	a#causa#de+estes	S+DMP	I
a#causa#destoutra	a#causa#de+esta+outra	S+DFS+IFS0	I
a#causa#destoutras	a#causa#de+estas+outras	S+DFP+IFP0	I
a#causa#destoutro	a#causa#de+este+outro	S+DMS+IMS0	I
a#causa#destoutros	a#causa#de+estes+outros	S+DMP+IMP0	I
a#causa#diso	a#causa#de+iso	S+DNS	I
a#causa#disto	a#causa#de+isto	S+DNS	I
a#causa#do	a#causa#de+o	S+GMS	I
a#causa#dos	a#causa#de+os	S+GMP	I
a#causa#doutra	a#causa#de+outra	S+IFS0	I
a#causa#doutras	a#causa#de+outras	S+IFP0	I
a#causa#doutro	a#causa#de+outro	S+IMS0	I
a#causa#doutros	a#causa#de+outros	S+IMP0	I
a#causa#dun	a#causa#de+un	S+IMS0	I
a#causa#dunha	a#causa#de+unha	S+IFS0	I
a#causa#dunhas	a#causa#de+unhas	S+IFP0	I
a#causa#duns	a#causa#de+uns	S+IMP0	I
a#diferenza#da	a#diferenza#de+a	S+GFS	I
a#diferenza#dalgún	a#diferenza#de+algún	S+IMS0	I
a#diferenza#dalgúns	a#diferenza#de+algúns	S+IMP0	I
a#diferenza#dalgunha	a#diferenza#de+algunha	S+IFS0	I
a#diferenza#dalgunhas	a#diferenza#de+algunhas	S+IFP0	I
a#diferenza#daquel	a#diferenza#de+aquel	S+DMS	I
a#diferenza#daquela	a#diferenza#de+aquela	S+DFS	I
a#diferenza#daquelas	a#diferenza#de+aquelas	S+DFP	I
a#diferenza#daqueles	a#diferenza#de+aqueles	S+DMP	I
a#diferenza#daqueloutra	a#diferenza#de+aquela+outra	S+DFS+IFS0	I
a#diferenza#daqueloutras	a#diferenza#de+aquelas+outras	S+DFP+IFP0	I
a#diferenza#daqueloutro	a#diferenza#de+aquel+outro	S+DMS+IMS0	I
a#diferenza#daqueloutros	a#diferenza#de+aqueles+outros	S+DMP+IMP0	I
a#diferenza#daquilo	a#diferenza#de+aquilo	S+DNS	I
a#diferenza#das	a#diferenza#de+as	S+GFP	I
a#diferenza#de	a#diferenza#de	S	I
a#diferenza#del	a#diferenza#de+el	S+P3MSB0	I
a#diferenza#dela	a#diferenza#de+ela	S+P3FSB0	I
a#diferenza#delas	a#diferenza#de+elas	S+P3FPB0	I
a#diferenza#deles	a#diferenza#de+eles	S+P3MPB0	I
a#diferenza#desa	a#diferenza#de+esa	S+DFS	I
a#diferenza#desas	a#diferenza#de+esas	S+DFP	I
a#diferenza#dese	a#diferenza#de+ese	S+DMS	I
a#diferenza#deses	a#diferenza#de+eses	S+DMP	I
a#diferenza#desoutra	a#diferenza#de+esa+outra	S+DFS+IFS0	I
a#diferenza#desoutras	a#diferenza#de+esas+outras	S+DFP+IFP0	I
a#diferenza#desoutro	a#diferenza#de+ese+outro	S+DMS+IMS0	I
a#diferenza#desoutros	a#diferenza#de+eses+outros	S+DMP+IMP0	I
a#diferenza#desta	a#diferenza#de+esta	S+DFS	I
a#diferenza#destas	a#diferenza#de+estas	S+DFP	I
a#diferenza#deste	a#diferenza#de+este	S+DMS	I
a#diferenza#destes	a#diferenza#de+estes	S+DMP	I
a#diferenza#destoutra	a#diferenza#de+esta+outra	S+DFS+IFS0	I
a#diferenza#destoutras	a#diferenza#de+estas+outras	S+DFP+IFP0	I
a#diferenza#destoutro	a#diferenza#de+este+outro	S+DMS+IMS0	I
a#diferenza#destoutros	a#diferenza#de+estes+outros	S+DMP+IMP0	I
a#diferenza#diso	a#diferenza#de+iso	S+DNS	I
a#diferenza#disto	a#diferenza#de+isto	S+DNS	I
a#diferenza#do	a#diferenza#de+o	S+GMS	I
a#diferenza#dos	a#diferenza#de+os	S+GMP	I
a#diferenza#doutra	a#diferenza#de+outra	S+IFS0	I
a#diferenza#doutras	a#diferenza#de+outras	S+IFP0	I
a#diferenza#doutro	a#diferenza#de+outro	S+IMS0	I
a#diferenza#doutros	a#diferenza#de+outros	S+IMP0	I
a#diferenza#dun	a#diferenza#de+un	S+IMS0	I
a#diferenza#dunha	a#diferenza#de+unha	S+IFS0	I
a#diferenza#dunhas	a#diferenza#de+unhas	S+IFP0	I
a#diferenza#duns	a#diferenza#de+uns	S+IMP0	I
a#forza#da	a#forza#de+a	S+GFS	I
a#forza#dalgún	a#forza#de+algún	S+IMS0	I
a#forza#dalgúns	a#forza#de+algúns	S+IMP0	I
a#forza#dalgunha	a#forza#de+algunha	S+IFS0	I
a#forza#dalgunhas	a#forza#de+algunhas	S+IFP0	I
a#forza#daquel	a#forza#de+aquel	S+DMS	I
a#forza#daquela	a#forza#de+aquela	S+DFS	I
a#forza#daquelas	a#forza#de+aquelas	S+DFP	I
a#forza#daqueles	a#forza#de+aqueles	S+DMP	I
a#forza#daqueloutra	a#forza#de+aquela+outra	S+DFS+IFS0	I
a#forza#daqueloutras	a#forza#de+aquelas+outras	S+DFP+IFP0	I
a#forza#daqueloutro	a#forza#de+aquel+outro	S+DMS+IMS0	I
a#forza#daqueloutros	a#forza#de+aqueles+outros	S+DMP+IMP0	I
a#forza#daquilo	a#forza#de+aquilo	S+DNS	I
a#forza#das	a#forza#de+as	S+GFP	I
a#forza#de	a#forza#de	S	I
a#forza#del	a#forza#de+el	S+P3MSB0	I
a#forza#dela	a#forza#de+ela	S+P3FSB0	I
a#forza#delas	a#forza#de+elas	S+P3FPB0	I
a#forza#deles	a#forza#de+eles	S+P3MPB0	I
a#forza#desa	a#forza#de+esa	S+DFS	I
a#forza#desas	a#forza#de+esas	S+DFP	I
a#forza#dese	a#forza#de+ese	S+DMS	I
a#forza#deses	a#forza#de+eses	S+DMP	I
a#forza#desoutra	a#forza#de+esa+outra	S+DFS+IFS0	I
a#forza#desoutras	a#forza#de+esas+outras	S+DFP+IFP0	I
a#forza#desoutro	a#forza#de+ese+outro	S+DMS+IMS0	I
a#forza#desoutros	a#forza#de+eses+outros	S+DMP+IMP0	I
a#forza#desta	a#forza#de+esta	S+DFS	I
a#forza#destas	a#forza#de+estas	S+DFP	I
a#forza#deste	a#forza#de+este	S+DMS	I
a#forza#destes	a#forza#de+estes	S+DMP	I
a#forza#destoutra	a#forza#de+esta+outra	S+DFS+IFS0	I
a#forza#destoutras	a#forza#de+estas+outras	S+DFP+IFP0	I
a#forza#destoutro	a#forza#de+este+outro	S+DMS+IMS0	I
a#forza#destoutros	a#forza#de+estes+outros	S+DMP+IMP0	I
a#forza#diso	a#forza#de+iso	S+DNS	I
a#forza#disto	a#forza#de+isto	S+DNS	I
a#forza#do	a#forza#de+o	S+GMS	I
a#forza#dos	a#forza#de+os	S+GMP	I
a#forza#doutra	a#forza#de+outra	S+IFS0	I
a#forza#doutras	a#forza#de+outras	S+IFP0	I
a#forza#doutro	a#forza#de+outro	S+IMS0	I
a#forza#doutros	a#forza#de+outros	S+IMP0	I
a#forza#dun	a#forza#de+un	S+IMS0	I
a#forza#dunha	a#forza#de+unha	S+IFS0	I
a#forza#dunhas	a#forza#de+unhas	S+IFP0	I
a#forza#duns	a#forza#de+uns	S+IMP0	I
a#par#da	a#par#de+a	S+GFS	I
a#par#dalgún	a#par#de+algún	S+IMS0	I
a#par#dalgúns	a#par#de+algúns	S+IMP0	I
a#par#dalgunha	a#par#de+algunha	S+IFS0	I
a#par#dalgunhas	a#par#de+algunhas	S+IFP0	I
a#par#daquel	a#par#de+aquel	S+DMS	I
a#par#daquela	a#par#de+aquela	S+DFS	I
a#par#daquelas	a#par#de+aquelas	S+DFP	I
a#par#daqueles	a#par#de+aqueles	S+DMP	I
a#par#daqueloutra	a#par#de+aquela+outra	S+DFS+IFS0	I
a#par#daqueloutras	a#par#de+aquelas+outras	S+DFP+IFP0	I
a#par#daqueloutro	a#par#de+aquel+outro	S+DMS+IMS0	I
a#par#daqueloutros	a#par#de+aqueles+outros	S+DMP+IMP0	I
a#par#daquilo	a#par#de+aquilo	S+DNS	I
a#par#das	a#par#de+as	S+GFP	I
a#par#de	a#par#de	S	I
a#par#del	a#par#de+el	S+P3MSB0	I
a#par#dela	a#par#de+ela	S+P3FSB0	I
a#par#delas	a#par#de+elas	S+P3FPB0	I
a#par#deles	a#par#de+eles	S+P3MPB0	I
a#par#desa	a#par#de+esa	S+DFS	I
a#par#desas	a#par#de+esas	S+DFP	I
a#par#dese	a#par#de+ese	S+DMS	I
a#par#deses	a#par#de+eses	S+DMP	I
a#par#desoutra	a#par#de+esa+outra	S+DFS+IFS0	I
a#par#desoutras	a#par#de+esas+outras	S+DFP+IFP0	I
a#par#desoutro	a#par#de+ese+outro	S+DMS+IMS0	I
a#par#desoutros	a#par#de+eses+outros	S+DMP+IMP0	I
a#par#desta	a#par#de+esta	S+DFS	I
a#par#destas	a#par#de+estas	S+DFP	I
a#par#deste	a#par#de+este	S+DMS	I
a#par#destes	a#par#de+estes	S+DMP	I
a#par#destoutra	a#par#de+esta+outra	S+DFS+IFS0	I
a#par#destoutras	a#par#de+estas+outras	S+DFP+IFP0	I
a#par#destoutro	a#par#de+este+outro	S+DMS+IMS0	I
a#par#destoutros	a#par#de+estes+outros	S+DMP+IMP0	I
a#par#diso	a#par#de+iso	S+DNS	I
a#par#disto	a#par#de+isto	S+DNS	I
a#par#do	a#par#de+o	S+GMS	I
a#par#dos	a#par#de+os	S+GMP	I
a#par#doutra	a#par#de+outra	S+IFS0	I
a#par#doutras	a#par#de+outras	S+IFP0	I
a#par#doutro	a#par#de+outro	S+IMS0	I
a#par#doutros	a#par#de+outros	S+IMP0	I
a#par#dun	a#par#de+un	S+IMS0	I
a#par#dunha	a#par#de+unha	S+IFS0	I
a#par#dunhas	a#par#de+unhas	S+IFP0	I
a#par#duns	a#par#de+uns	S+IMP0	I
a#pesar#da	a#pesar#de+a	S+GFS	I
a#pesar#dalgún	a#pesar#de+algún	S+IMS0	I
a#pesar#dalgúns	a#pesar#de+algúns	S+IMP0	I
a#pesar#dalgunha	a#pesar#de+algunha	S+IFS0	I
a#pesar#dalgunhas	a#pesar#de+algunhas	S+IFP0	I
a#pesar#daquel	a#pesar#de+aquel	S+DMS	I
a#pesar#daquela	a#pesar#de+aquela	S+DFS	I
a#pesar#daquelas	a#pesar#de+aquelas	S+DFP	I
a#pesar#daqueles	a#pesar#de+aqueles	S+DMP	I
a#pesar#daqueloutra	a#pesar#de+aquela+outra	S+DFS+IFS0	I
a#pesar#daqueloutras	a#pesar#de+aquelas+outras	S+DFP+IFP0	I
a#pesar#daqueloutro	a#pesar#de+aquel+outro	S+DMS+IMS0	I
a#pesar#daqueloutros	a#pesar#de+aqueles+outros	S+DMP+IMP0	I
a#pesar#daquilo	a#pesar#de+aquilo	S+DNS	I
a#pesar#das	a#pesar#de+as	S+GFP	I
a#pesar#de	a#pesar#de	S	I
a#pesar#del	a#pesar#de+el	S+P3MSB0	I
a#pesar#dela	a#pesar#de+ela	S+P3FSB0	I
a#pesar#delas	a#pesar#de+elas	S+P3FPB0	I
a#pesar#deles	a#pesar#de+eles	S+P3MPB0	I
a#pesar#desa	a#pesar#de+esa	S+DFS	I
a#pesar#desas	a#pesar#de+esas	S+DFP	I
a#pesar#dese	a#pesar#de+ese	S+DMS	I
a#pesar#deses	a#pesar#de+eses	S+DMP	I
a#pesar#desoutra	a#pesar#de+esa+outra	S+DFS+IFS0	I
a#pesar#desoutras	a#pesar#de+esas+outras	S+DFP+IFP0	I
a#pesar#desoutro	a#pesar#de+ese+outro	S+DMS+IMS0	I
a#pesar#desoutros	a#pesar#de+eses+outros	S+DMP+IMP0	I
a#pesar#destoutra	a#pesar#de+esta+outra	S+DFS+IFS0	I
a#pesar#destoutras	a#pesar#de+estas+outras	S+DFP+IFP0	I
a#pesar#destoutro	a#pesar#de+este+outro	S+DMS+IMS0	I
a#pesar#destoutros	a#pesar#de+estes+outros	S+DMP+IMP0	I
a#pesar#diso	a#pesar#de+iso	S+DNS	I
a#pesar#disto	a#pesar#de+isto	S+DNS	I
a#pesar#do	a#pesar#de+o	S+GMS	I
a#pesar#dos	a#pesar#de+os	S+GMP	I
a#pesar#doutra	a#pesar#de+outra	S+IFS0	I
a#pesar#doutras	a#pesar#de+outras	S+IFP0	I
a#pesar#doutro	a#pesar#de+outro	S+IMS0	I
a#pesar#doutros	a#pesar#de+outros	S+IMP0	I
a#pesar#dun	a#pesar#de+un	S+IMS0	I
a#pesar#dunha	a#pesar#de+unha	S+IFS0	I
a#pesar#dunhas	a#pesar#de+unhas	S+IFP0	I
a#pesar#duns	a#pesar#de+uns	S+IMP0	I
a#pesar#desta	a#pesar#de+esta	S+DFS	I
a#pesar#destas	a#pesar#de+estas	S+DFP	I
a#pesar#deste	a#pesar#de+este	S+DMS	I
a#pesar#destes	a#pesar#de+estes	S+DMP	I
a#poder#da	a#poder#de+a	S+GFS	I
a#poder#dalgún	a#poder#de+algún	S+IMS0	I
a#poder#dalgúns	a#poder#de+algúns	S+IMP0	I
a#poder#dalgunha	a#poder#de+algunha	S+IFS0	I
a#poder#dalgunhas	a#poder#de+algunhas	S+IFP0	I
a#poder#daquel	a#poder#de+aquel	S+DMS	I
a#poder#daquela	a#poder#de+aquela	S+DFS	I
a#poder#daquelas	a#poder#de+aquelas	S+DFP	I
a#poder#daqueles	a#poder#de+aqueles	S+DMP	I
a#poder#daqueloutra	a#poder#de+aquela+outra	S+DFS+IFS0	I
a#poder#daqueloutras	a#poder#de+aquelas+outras	S+DFP+IFP0	I
a#poder#daqueloutro	a#poder#de+aquel+outro	S+DMS+IMS0	I
a#poder#daqueloutros	a#poder#de+aqueles+outros	S+DMP+IMP0	I
a#poder#daquilo	a#poder#de+aquilo	S+DNS	I
a#poder#das	a#poder#de+as	S+GFP	I
a#poder#de	a#poder#de	S	I
a#poder#del	a#poder#de+el	S+P3MSB0	I
a#poder#dela	a#poder#de+ela	S+P3FSB0	I
a#poder#delas	a#poder#de+elas	S+P3FPB0	I
a#poder#deles	a#poder#de+eles	S+P3MPB0	I
a#poder#desa	a#poder#de+esa	S+DFS	I
a#poder#desas	a#poder#de+esas	S+DFP	I
a#poder#dese	a#poder#de+ese	S+DMS	I
a#poder#deses	a#poder#de+eses	S+DMP	I
a#poder#desoutra	a#poder#de+esa+outra	S+DFS+IFS0	I
a#poder#desoutras	a#poder#de+esas+outras	S+DFP+IFP0	I
a#poder#desoutro	a#poder#de+ese+outro	S+DMS+IMS0	I
a#poder#desoutros	a#poder#de+eses+outros	S+DMP+IMP0	I
a#poder#desta	a#poder#de+esta	S+DFS	I
a#poder#destas	a#poder#de+estas	S+DFP	I
a#poder#deste	a#poder#de+este	S+DMS	I
a#poder#destes	a#poder#de+estes	S+DMP	I
a#poder#destoutra	a#poder#de+esta+outra	S+DFS+IFS0	I
a#poder#destoutras	a#poder#de+estas+outras	S+DFP+IFP0	I
a#poder#destoutro	a#poder#de+este+outro	S+DMS+IMS0	I
a#poder#destoutros	a#poder#de+estes+outros	S+DMP+IMP0	I
a#poder#diso	a#poder#de+iso	S+DNS	I
a#poder#disto	a#poder#de+isto	S+DNS	I
a#poder#do	a#poder#de+o	S+GMS	I
a#poder#dos	a#poder#de+os	S+GMP	I
a#poder#doutra	a#poder#de+outra	S+IFS0	I
a#poder#doutras	a#poder#de+outras	S+IFP0	I
a#poder#doutro	a#poder#de+outro	S+IMS0	I
a#poder#doutros	a#poder#de+outros	S+IMP0	I
a#poder#dun	a#poder#de+un	S+IMS0	I
a#poder#dunha	a#poder#de+unha	S+IFS0	I
a#poder#dunhas	a#poder#de+unhas	S+IFP0	I
a#poder#duns	a#poder#de+uns	S+IMP0	I
a#por#da	a#por#de+a	S+GFS	I
a#por#dalgún	a#por#de+algún	S+IMS0	I
a#por#dalgúns	a#por#de+algúns	S+IMP0	I
a#por#dalgunha	a#por#de+algunha	S+IFS0	I
a#por#dalgunhas	a#por#de+algunhas	S+IFP0	I
a#por#daquel	a#por#de+aquel	S+DMS	I
a#por#daquela	a#por#de+aquela	S+DFS	I
a#por#daquelas	a#por#de+aquelas	S+DFP	I
a#por#daqueles	a#por#de+aqueles	S+DMP	I
a#por#daqueloutra	a#por#de+aquela+outra	S+DFS+IFS0	I
a#por#daqueloutras	a#por#de+aquelas+outras	S+DFP+IFP0	I
a#por#daqueloutro	a#por#de+aquel+outro	S+DMS+IMS0	I
a#por#daqueloutros	a#por#de+aqueles+outros	S+DMP+IMP0	I
a#por#daquilo	a#por#de+aquilo	S+DNS	I
a#por#das	a#por#de+as	S+GFP	I
a#por#de	a#por#de	S	I
a#por#del	a#por#de+el	S+P3MSB0	I
a#por#dela	a#por#de+ela	S+P3FSB0	I
a#por#delas	a#por#de+elas	S+P3FPB0	I
a#por#deles	a#por#de+eles	S+P3MPB0	I
a#por#desa	a#por#de+esa	S+DFS	I
a#por#desas	a#por#de+esas	S+DFP	I
a#por#dese	a#por#de+ese	S+DMS	I
a#por#deses	a#por#de+eses	S+DMP	I
a#por#desoutra	a#por#de+esa+outra	S+DFS+IFS0	I
a#por#desoutras	a#por#de+esas+outras	S+DFP+IFP0	I
a#por#desoutro	a#por#de+ese+outro	S+DMS+IMS0	I
a#por#desoutros	a#por#de+eses+outros	S+DMP+IMP0	I
a#por#desta	a#por#de+esta	S+DFS	I
a#por#destas	a#por#de+estas	S+DFP	I
a#por#deste	a#por#de+este	S+DMS	I
a#por#destes	a#por#de+estes	S+DMP	I
a#por#destoutra	a#por#de+esta+outra	S+DFS+IFS0	I
a#por#destoutras	a#por#de+estas+outras	S+DFP+IFP0	I
a#por#destoutro	a#por#de+este+outro	S+DMS+IMS0	I
a#por#destoutros	a#por#de+estes+outros	S+DMP+IMP0	I
a#por#diso	a#por#de+iso	S+DNS	I
a#por#disto	a#por#de+isto	S+DNS	I
a#por#do	a#por#de+o	S+GMS	I
a#por#dos	a#por#de+os	S+GMP	I
a#por#doutra	a#por#de+outra	S+IFS0	I
a#por#doutras	a#por#de+outras	S+IFP0	I
a#por#doutro	a#por#de+outro	S+IMS0	I
a#por#doutros	a#por#de+outros	S+IMP0	I
a#por#dun	a#por#de+un	S+IMS0	I
a#por#dunha	a#por#de+unha	S+IFS0	I
a#por#dunhas	a#por#de+unhas	S+IFP0	I
a#por#duns	a#por#de+uns	S+IMP0	I
a#prol#da	a#prol#de+a	S+GFS	I
a#prol#dalgún	a#prol#de+algún	S+IMS0	I
a#prol#dalgúns	a#prol#de+algúns	S+IMP0	I
a#prol#dalgunha	a#prol#de+algunha	S+IFS0	I
a#prol#dalgunhas	a#prol#de+algunhas	S+IFP0	I
a#prol#daquel	a#prol#de+aquel	S+DMS	I
a#prol#daquela	a#prol#de+aquela	S+DFS	I
a#prol#daquelas	a#prol#de+aquelas	S+DFP	I
a#prol#daqueles	a#prol#de+aqueles	S+DMP	I
a#prol#daqueloutra	a#prol#de+aquela+outra	S+DFS+IFS0	I
a#prol#daqueloutras	a#prol#de+aquelas+outras	S+DFP+IFP0	I
a#prol#daqueloutro	a#prol#de+aquel+outro	S+DMS+IMS0	I
a#prol#daqueloutros	a#prol#de+aqueles+outros	S+DMP+IMP0	I
a#prol#daquilo	a#prol#de+aquilo	S+DNS	I
a#prol#das	a#prol#de+as	S+GFP	I
a#prol#de	a#prol#de	S	I
a#prol#del	a#prol#de+el	S+P3MSB0	I
a#prol#dela	a#prol#de+ela	S+P3FSB0	I
a#prol#delas	a#prol#de+elas	S+P3FPB0	I
a#prol#deles	a#prol#de+eles	S+P3MPB0	I
a#prol#desa	a#prol#de+esa	S+DFS	I
a#prol#desas	a#prol#de+esas	S+DFP	I
a#prol#dese	a#prol#de+ese	S+DMS	I
a#prol#deses	a#prol#de+eses	S+DMP	I
a#prol#desoutra	a#prol#de+esa+outra	S+DFS+IFS0	I
a#prol#desoutras	a#prol#de+esas+outras	S+DFP+IFP0	I
a#prol#desoutro	a#prol#de+ese+outro	S+DMS+IMS0	I
a#prol#desoutros	a#prol#de+eses+outros	S+DMP+IMP0	I
a#prol#desta	a#prol#de+esta	S+DFS	I
a#prol#destas	a#prol#de+estas	S+DFP	I
a#prol#deste	a#prol#de+este	S+DMS	I
a#prol#destes	a#prol#de+estes	S+DMP	I
a#prol#destoutra	a#prol#de+esta+outra	S+DFS+IFS0	I
a#prol#destoutras	a#prol#de+estas+outras	S+DFP+IFP0	I
a#prol#destoutro	a#prol#de+este+outro	S+DMS+IMS0	I
a#prol#destoutros	a#prol#de+estes+outros	S+DMP+IMP0	I
a#prol#diso	a#prol#de+iso	S+DNS	I
a#prol#disto	a#prol#de+isto	S+DNS	I
a#prol#do	a#prol#de+o	S+GMS	I
a#prol#dos	a#prol#de+os	S+GMP	I
a#prol#doutra	a#prol#de+outra	S+IFS0	I
a#prol#doutras	a#prol#de+outras	S+IFP0	I
a#prol#doutro	a#prol#de+outro	S+IMS0	I
a#prol#doutros	a#prol#de+outros	S+IMP0	I
a#prol#dun	a#prol#de+un	S+IMS0	I
a#prol#dunha	a#prol#de+unha	S+IFS0	I
a#prol#dunhas	a#prol#de+unhas	S+IFP0	I
a#prol#duns	a#prol#de+uns	S+IMP0	I
a#rente#da	a#rente#de+a	S+GFS	I
a#rente#dalgún	a#rente#de+algún	S+IMS0	I
a#rente#dalgúns	a#rente#de+algúns	S+IMP0	I
a#rente#dalgunha	a#rente#de+algunha	S+IFS0	I
a#rente#dalgunhas	a#rente#de+algunhas	S+IFP0	I
a#rente#daquel	a#rente#de+aquel	S+DMS	I
a#rente#daquela	a#rente#de+aquela	S+DFS	I
a#rente#daquelas	a#rente#de+aquelas	S+DFP	I
a#rente#daqueles	a#rente#de+aqueles	S+DMP	I
a#rente#daqueloutra	a#rente#de+aquela+outra	S+DFS+IFS0	I
a#rente#daqueloutras	a#rente#de+aquelas+outras	S+DFP+IFP0	I
a#rente#daqueloutro	a#rente#de+aquel+outro	S+DMS+IMS0	I
a#rente#daqueloutros	a#rente#de+aqueles+outros	S+DMP+IMP0	I
a#rente#daquilo	a#rente#de+aquilo	S+DNS	I
a#rente#das	a#rente#de+as	S+GFP	I
a#rente#de	a#rente#de	S	I
a#rente#del	a#rente#de+el	S+P3MSB0	I
a#rente#dela	a#rente#de+ela	S+P3FSB0	I
a#rente#delas	a#rente#de+elas	S+P3FPB0	I
a#rente#deles	a#rente#de+eles	S+P3MPB0	I
a#rente#desa	a#rente#de+esa	S+DFS	I
a#rente#desas	a#rente#de+esas	S+DFP	I
a#rente#dese	a#rente#de+ese	S+DMS	I
a#rente#deses	a#rente#de+eses	S+DMP	I
a#rente#desoutra	a#rente#de+esa+outra	S+DFS+IFS0	I
a#rente#desoutras	a#rente#de+esas+outras	S+DFP+IFP0	I
a#rente#desoutro	a#rente#de+ese+outro	S+DMS+IMS0	I
a#rente#desoutros	a#rente#de+eses+outros	S+DMP+IMP0	I
a#rente#desta	a#rente#de+esta	S+DFS	I
a#rente#destas	a#rente#de+estas	S+DFP	I
a#rente#deste	a#rente#de+este	S+DMS	I
a#rente#destes	a#rente#de+estes	S+DMP	I
a#rente#destoutra	a#rente#de+esta+outra	S+DFS+IFS0	I
a#rente#destoutras	a#rente#de+estas+outras	S+DFP+IFP0	I
a#rente#destoutro	a#rente#de+este+outro	S+DMS+IMS0	I
a#rente#destoutros	a#rente#de+estes+outros	S+DMP+IMP0	I
a#rente#diso	a#rente#de+iso	S+DNS	I
a#rente#disto	a#rente#de+isto	S+DNS	I
a#rente#do	a#rente#de+o	S+GMS	I
a#rente#dos	a#rente#de+os	S+GMP	I
a#rente#doutra	a#rente#de+outra	S+IFS0	I
a#rente#doutras	a#rente#de+outras	S+IFP0	I
a#rente#doutro	a#rente#de+outro	S+IMS0	I
a#rente#doutros	a#rente#de+outros	S+IMP0	I
a#rente#dun	a#rente#de+un	S+IMS0	I
a#rente#dunha	a#rente#de+unha	S+IFS0	I
a#rente#dunhas	a#rente#de+unhas	S+IFP0	I
a#rente#duns	a#rente#de+uns	S+IMP0	I
a#rentes#da	a#rentes#de+a	S+GFS	I
a#rentes#dalgún	a#rentes#de+algún	S+IMS0	I
a#rentes#dalgúns	a#rentes#de+algúns	S+IMP0	I
a#rentes#dalgunha	a#rentes#de+algunha	S+IFS0	I
a#rentes#dalgunhas	a#rentes#de+algunhas	S+IFP0	I
a#rentes#daquel	a#rentes#de+aquel	S+DMS	I
a#rentes#daquela	a#rentes#de+aquela	S+DFS	I
a#rentes#daquelas	a#rentes#de+aquelas	S+DFP	I
a#rentes#daqueles	a#rentes#de+aqueles	S+DMP	I
a#rentes#daqueloutra	a#rentes#de+aquela+outra	S+DFS+IFS0	I
a#rentes#daqueloutras	a#rentes#de+aquelas+outras	S+DFP+IFP0	I
a#rentes#daqueloutro	a#rentes#de+aquel+outro	S+DMS+IMS0	I
a#rentes#daqueloutros	a#rentes#de+aqueles+outros	S+DMP+IMP0	I
a#rentes#daquilo	a#rentes#de+aquilo	S+DNS	I
a#rentes#das	a#rentes#de+as	S+GFP	I
a#rentes#de	a#rentes#de	S	I
a#rentes#del	a#rentes#de+el	S+P3MSB0	I
a#rentes#dela	a#rentes#de+ela	S+P3FSB0	I
a#rentes#delas	a#rentes#de+elas	S+P3FPB0	I
a#rentes#deles	a#rentes#de+eles	S+P3MPB0	I
a#rentes#desa	a#rentes#de+esa	S+DFS	I
a#rentes#desas	a#rentes#de+esas	S+DFP	I
a#rentes#dese	a#rentes#de+ese	S+DMS	I
a#rentes#deses	a#rentes#de+eses	S+DMP	I
a#rentes#desoutra	a#rentes#de+esa+outra	S+DFS+IFS0	I
a#rentes#desoutras	a#rentes#de+esas+outras	S+DFP+IFP0	I
a#rentes#desoutro	a#rentes#de+ese+outro	S+DMS+IMS0	I
a#rentes#desoutros	a#rentes#de+eses+outros	S+DMP+IMP0	I
a#rentes#desta	a#rentes#de+esta	S+DFS	I
a#rentes#destas	a#rentes#de+estas	S+DFP	I
a#rentes#deste	a#rentes#de+este	S+DMS	I
a#rentes#destes	a#rentes#de+estes	S+DMP	I
a#rentes#destoutra	a#rentes#de+esta+outra	S+DFS+IFS0	I
a#rentes#destoutras	a#rentes#de+estas+outras	S+DFP+IFP0	I
a#rentes#destoutro	a#rentes#de+este+outro	S+DMS+IMS0	I
a#rentes#destoutros	a#rentes#de+estes+outros	S+DMP+IMP0	I
a#rentes#diso	a#rentes#de+iso	S+DNS	I
a#rentes#disto	a#rentes#de+isto	S+DNS	I
a#rentes#do	a#rentes#de+o	S+GMS	I
a#rentes#dos	a#rentes#de+os	S+GMP	I
a#rentes#doutra	a#rentes#de+outra	S+IFS0	I
a#rentes#doutras	a#rentes#de+outras	S+IFP0	I
a#rentes#doutro	a#rentes#de+outro	S+IMS0	I
a#rentes#doutros	a#rentes#de+outros	S+IMP0	I
a#rentes#dun	a#rentes#de+un	S+IMS0	I
a#rentes#dunha	a#rentes#de+unha	S+IFS0	I
a#rentes#dunhas	a#rentes#de+unhas	S+IFP0	I
a#rentes#duns	a#rentes#de+uns	S+IMP0	I
a#respecto#da	a#respecto#de+a	S+GFS	I
a#respecto#dalgún	a#respecto#de+algún	S+IMS0	I
a#respecto#dalgúns	a#respecto#de+algúns	S+IMP0	I
a#respecto#dalgunha	a#respecto#de+algunha	S+IFS0	I
a#respecto#dalgunhas	a#respecto#de+algunhas	S+IFP0	I
a#respecto#daquel	a#respecto#de+aquel	S+DMS	I
a#respecto#daquela	a#respecto#de+aquela	S+DFS	I
a#respecto#daquelas	a#respecto#de+aquelas	S+DFP	I
a#respecto#daqueles	a#respecto#de+aqueles	S+DMP	I
a#respecto#daqueloutra	a#respecto#de+aquela+outra	S+DFS+IFS0	I
a#respecto#daqueloutras	a#respecto#de+aquelas+outras	S+DFP+IFP0	I
a#respecto#daqueloutro	a#respecto#de+aquel+outro	S+DMS+IMS0	I
a#respecto#daqueloutros	a#respecto#de+aqueles+outros	S+DMP+IMP0	I
a#respecto#daquilo	a#respecto#de+aquilo	S+DNS	I
a#respecto#das	a#respecto#de+as	S+GFP	I
a#respecto#de	a#respecto#de	S	I
a#respecto#del	a#respecto#de+el	S+P3MSB0	I
a#respecto#dela	a#respecto#de+ela	S+P3FSB0	I
a#respecto#delas	a#respecto#de+elas	S+P3FPB0	I
a#respecto#deles	a#respecto#de+eles	S+P3MPB0	I
a#respecto#desa	a#respecto#de+esa	S+DFS	I
a#respecto#desas	a#respecto#de+esas	S+DFP	I
a#respecto#dese	a#respecto#de+ese	S+DMS	I
a#respecto#deses	a#respecto#de+eses	S+DMP	I
a#respecto#desoutra	a#respecto#de+esa+outra	S+DFS+IFS0	I
a#respecto#desoutras	a#respecto#de+esas+outras	S+DFP+IFP0	I
a#respecto#desoutro	a#respecto#de+ese+outro	S+DMS+IMS0	I
a#respecto#desoutros	a#respecto#de+eses+outros	S+DMP+IMP0	I
a#respecto#desta	a#respecto#de+esta	S+DFS	I
a#respecto#destas	a#respecto#de+estas	S+DFP	I
a#respecto#deste	a#respecto#de+este	S+DMS	I
a#respecto#destes	a#respecto#de+estes	S+DMP	I
a#respecto#destoutra	a#respecto#de+esta+outra	S+DFS+IFS0	I
a#respecto#destoutras	a#respecto#de+estas+outras	S+DFP+IFP0	I
a#respecto#destoutro	a#respecto#de+este+outro	S+DMS+IMS0	I
a#respecto#destoutros	a#respecto#de+estes+outros	S+DMP+IMP0	I
a#respecto#diso	a#respecto#de+iso	S+DNS	I
a#respecto#disto	a#respecto#de+isto	S+DNS	I
a#respecto#do	a#respecto#de+o	S+GMS	I
a#respecto#dos	a#respecto#de+os	S+GMP	I
a#respecto#doutra	a#respecto#de+outra	S+IFS0	I
a#respecto#doutras	a#respecto#de+outras	S+IFP0	I
a#respecto#doutro	a#respecto#de+outro	S+IMS0	I
a#respecto#doutros	a#respecto#de+outros	S+IMP0	I
a#respecto#dun	a#respecto#de+un	S+IMS0	I
a#respecto#dunha	a#respecto#de+unha	S+IFS0	I
a#respecto#dunhas	a#respecto#de+unhas	S+IFP0	I
a#respecto#duns	a#respecto#de+uns	S+IMP0	I
a#son#da	a#son#de+a	S+GFS	I
a#son#dalgún	a#son#de+algún	S+IMS0	I
a#son#dalgúns	a#son#de+algúns	S+IMP0	I
a#son#dalgunha	a#son#de+algunha	S+IFS0	I
a#son#dalgunhas	a#son#de+algunhas	S+IFP0	I
a#son#daquel	a#son#de+aquel	S+DMS	I
a#son#daquela	a#son#de+aquela	S+DFS	I
a#son#daquelas	a#son#de+aquelas	S+DFP	I
a#son#daqueles	a#son#de+aqueles	S+DMP	I
a#son#daqueloutra	a#son#de+aquela+outra	S+DFS+IFS0	I
a#son#daqueloutras	a#son#de+aquelas+outras	S+DFP+IFP0	I
a#son#daqueloutro	a#son#de+aquel+outro	S+DMS+IMS0	I
a#son#daqueloutros	a#son#de+aqueles+outros	S+DMP+IMP0	I
a#son#daquilo	a#son#de+aquilo	S+DNS	I
a#son#das	a#son#de+as	S+GFP	I
a#son#de	a#son#de	S	I
a#son#del	a#son#de+el	S+P3MSB0	I
a#son#dela	a#son#de+ela	S+P3FSB0	I
a#son#delas	a#son#de+elas	S+P3FPB0	I
a#son#deles	a#son#de+eles	S+P3MPB0	I
a#son#desa	a#son#de+esa	S+DFS	I
a#son#desas	a#son#de+esas	S+DFP	I
a#son#dese	a#son#de+ese	S+DMS	I
a#son#deses	a#son#de+eses	S+DMP	I
a#son#desoutra	a#son#de+esa+outra	S+DFS+IFS0	I
a#son#desoutras	a#son#de+esas+outras	S+DFP+IFP0	I
a#son#desoutro	a#son#de+ese+outro	S+DMS+IMS0	I
a#son#desoutros	a#son#de+eses+outros	S+DMP+IMP0	I
a#son#desta	a#son#de+esta	S+DFS	I
a#son#destas	a#son#de+estas	S+DFP	I
a#son#deste	a#son#de+este	S+DMS	I
a#son#destes	a#son#de+estes	S+DMP	I
a#son#destoutra	a#son#de+esta+outra	S+DFS+IFS0	I
a#son#destoutras	a#son#de+estas+outras	S+DFP+IFP0	I
a#son#destoutro	a#son#de+este+outro	S+DMS+IMS0	I
a#son#destoutros	a#son#de+estes+outros	S+DMP+IMP0	I
a#son#diso	a#son#de+iso	S+DNS	I
a#son#disto	a#son#de+isto	S+DNS	I
a#son#do	a#son#de+o	S+GMS	I
a#son#dos	a#son#de+os	S+GMP	I
a#son#doutra	a#son#de+outra	S+IFS0	I
a#son#doutras	a#son#de+outras	S+IFP0	I
a#son#doutro	a#son#de+outro	S+IMS0	I
a#son#doutros	a#son#de+outros	S+IMP0	I
a#son#dun	a#son#de+un	S+IMS0	I
a#son#dunha	a#son#de+unha	S+IFS0	I
a#son#dunhas	a#son#de+unhas	S+IFP0	I
a#son#duns	a#son#de+uns	S+IMP0	I
a#través#da	a#través#de+a	S+GFS	I
a#través#dalgún	a#través#de+algún	S+IMS0	I
a#través#dalgúns	a#través#de+algúns	S+IMP0	I
a#través#dalgunha	a#través#de+algunha	S+IFS0	I
a#través#dalgunhas	a#través#de+algunhas	S+IFP0	I
a#través#daquel	a#través#de+aquel	S+DMS	I
a#través#daquela	a#través#de+aquela	S+DFS	I
a#través#daquelas	a#través#de+aquelas	S+DFP	I
a#través#daqueles	a#través#de+aqueles	S+DMP	I
a#través#daqueloutra	a#través#de+aquela+outra	S+DFS+IFS0	I
a#través#daqueloutras	a#través#de+aquelas+outras	S+DFP+IFP0	I
a#través#daqueloutro	a#través#de+aquel+outro	S+DMS+IMS0	I
a#través#daqueloutros	a#través#de+aqueles+outros	S+DMP+IMP0	I
a#través#daquilo	a#través#de+aquilo	S+DNS	I
a#través#das	a#través#de+as	S+GFP	I
a#través#de	a#través#de	S	I
a#través#del	a#través#de+el	S+P3MSB0	I
a#través#dela	a#través#de+ela	S+P3FSB0	I
a#través#delas	a#través#de+elas	S+P3FPB0	I
a#través#deles	a#través#de+eles	S+P3MPB0	I
a#través#desa	a#través#de+esa	S+DFS	I
a#través#desas	a#través#de+esas	S+DFP	I
a#través#dese	a#través#de+ese	S+DMS	I
a#través#deses	a#través#de+eses	S+DMP	I
a#través#desoutra	a#través#de+esa+outra	S+DFS+IFS0	I
a#través#desoutras	a#través#de+esas+outras	S+DFP+IFP0	I
a#través#desoutro	a#través#de+ese+outro	S+DMS+IMS0	I
a#través#desoutros	a#través#de+eses+outros	S+DMP+IMP0	I
a#través#desta	a#través#de+esta	S+DFS	I
a#través#destas	a#través#de+estas	S+DFP	I
a#través#deste	a#través#de+este	S+DMS	I
a#través#destes	a#través#de+estes	S+DMP	I
a#través#destoutra	a#través#de+esta+outra	S+DFS+IFS0	I
a#través#destoutras	a#través#de+estas+outras	S+DFP+IFP0	I
a#través#destoutro	a#través#de+este+outro	S+DMS+IMS0	I
a#través#destoutros	a#través#de+estes+outros	S+DMP+IMP0	I
a#través#diso	a#través#de+iso	S+DNS	I
a#través#disto	a#través#de+isto	S+DNS	I
a#través#do	a#través#de+o	S+GMS	I
a#través#dos	a#través#de+os	S+GMP	I
a#través#doutra	a#través#de+outra	S+IFS0	I
a#través#doutras	a#través#de+outras	S+IFP0	I
a#través#doutro	a#través#de+outro	S+IMS0	I
a#través#doutros	a#través#de+outros	S+IMP0	I
a#través#dun	a#través#de+un	S+IMS0	I
a#través#dunha	a#través#de+unha	S+IFS0	I
a#través#dunhas	a#través#de+unhas	S+IFP0	I
a#través#duns	a#través#de+uns	S+IMP0	I
abaixo#da	abaixo#de+a	S+GFS	I
abaixo#dalgún	abaixo#de+algún	S+IMS0	I
abaixo#dalgúns	abaixo#de+algúns	S+IMP0	I
abaixo#dalgunha	abaixo#de+algunha	S+IFS0	I
abaixo#dalgunhas	abaixo#de+algunhas	S+IFP0	I
abaixo#daquel	abaixo#de+aquel	S+DMS	I
abaixo#daquela	abaixo#de+aquela	S+DFS	I
abaixo#daquelas	abaixo#de+aquelas	S+DFP	I
abaixo#daqueles	abaixo#de+aqueles	S+DMP	I
abaixo#daqueloutra	abaixo#de+aquela+outra	S+DFS+IFS0	I
abaixo#daqueloutras	abaixo#de+aquelas+outras	S+DFP+IFP0	I
abaixo#daqueloutro	abaixo#de+aquel+outro	S+DMS+IMS0	I
abaixo#daqueloutros	abaixo#de+aqueles+outros	S+DMP+IMP0	I
abaixo#daquilo	abaixo#de+aquilo	S+DNS	I
abaixo#das	abaixo#de+as	S+GFP	I
abaixo#de	abaixo#de	S	I
abaixo#del	abaixo#de+el	S+P3MSB0	I
abaixo#dela	abaixo#de+ela	S+P3FSB0	I
abaixo#delas	abaixo#de+elas	S+P3FPB0	I
abaixo#deles	abaixo#de+eles	S+P3MPB0	I
abaixo#desa	abaixo#de+esa	S+DFS	I
abaixo#desas	abaixo#de+esas	S+DFP	I
abaixo#dese	abaixo#de+ese	S+DMS	I
abaixo#deses	abaixo#de+eses	S+DMP	I
abaixo#desoutra	abaixo#de+esa+outra	S+DFS+IFS0	I
abaixo#desoutras	abaixo#de+esas+outras	S+DFP+IFP0	I
abaixo#desoutro	abaixo#de+ese+outro	S+DMS+IMS0	I
abaixo#desoutros	abaixo#de+eses+outros	S+DMP+IMP0	I
abaixo#desta	abaixo#de+esta	S+DFS	I
abaixo#destas	abaixo#de+estas	S+DFP	I
abaixo#deste	abaixo#de+este	S+DMS	I
abaixo#destes	abaixo#de+estes	S+DMP	I
abaixo#destoutra	abaixo#de+esta+outra	S+DFS+IFS0	I
abaixo#destoutras	abaixo#de+estas+outras	S+DFP+IFP0	I
abaixo#destoutro	abaixo#de+este+outro	S+DMS+IMS0	I
abaixo#destoutros	abaixo#de+estes+outros	S+DMP+IMP0	I
abaixo#diso	abaixo#de+iso	S+DNS	I
abaixo#disto	abaixo#de+isto	S+DNS	I
abaixo#do	abaixo#de+o	S+GMS	I
abaixo#dos	abaixo#de+os	S+GMP	I
abaixo#doutra	abaixo#de+outra	S+IFS0	I
abaixo#doutras	abaixo#de+outras	S+IFP0	I
abaixo#doutro	abaixo#de+outro	S+IMS0	I
abaixo#doutros	abaixo#de+outros	S+IMP0	I
abaixo#dun	abaixo#de+un	S+IMS0	I
abaixo#dunha	abaixo#de+unha	S+IFS0	I
abaixo#dunhas	abaixo#de+unhas	S+IFP0	I
abaixo#duns	abaixo#de+uns	S+IMP0	I
acerca#da	acerca#de+a	S+GFS	I
acerca#dalgún	acerca#de+algún	S+IMS0	I
acerca#dalgúns	acerca#de+algúns	S+IMP0	I
acerca#dalgunha	acerca#de+algunha	S+IFS0	I
acerca#dalgunhas	acerca#de+algunhas	S+IFP0	I
acerca#daquel	acerca#de+aquel	S+DMS	I
acerca#daquela	acerca#de+aquela	S+DFS	I
acerca#daquelas	acerca#de+aquelas	S+DFP	I
acerca#daqueles	acerca#de+aqueles	S+DMP	I
acerca#daqueloutra	acerca#de+aquela+outra	S+DFS+IFS0	I
acerca#daqueloutras	acerca#de+aquelas+outras	S+DFP+IFP0	I
acerca#daqueloutro	acerca#de+aquel+outro	S+DMS+IMS0	I
acerca#daqueloutros	acerca#de+aqueles+outros	S+DMP+IMP0	I
acerca#daquilo	acerca#de+aquilo	S+DNS	I
acerca#das	acerca#de+as	S+GFP	I
acerca#de	acerca#de	S	I
acerca#del	acerca#de+el	S+P3MSB0	I
acerca#dela	acerca#de+ela	S+P3FSB0	I
acerca#delas	acerca#de+elas	S+P3FPB0	I
acerca#deles	acerca#de+eles	S+P3MPB0	I
acerca#desa	acerca#de+esa	S+DFS	I
acerca#desas	acerca#de+esas	S+DFP	I
acerca#dese	acerca#de+ese	S+DMS	I
acerca#deses	acerca#de+eses	S+DMP	I
acerca#desoutra	acerca#de+esa+outra	S+DFS+IFS0	I
acerca#desoutras	acerca#de+esas+outras	S+DFP+IFP0	I
acerca#desoutro	acerca#de+ese+outro	S+DMS+IMS0	I
acerca#desoutros	acerca#de+eses+outros	S+DMP+IMP0	I
acerca#desta	acerca#de+esta	S+DFS	I
acerca#destas	acerca#de+estas	S+DFP	I
acerca#deste	acerca#de+este	S+DMS	I
acerca#destes	acerca#de+estes	S+DMP	I
acerca#destoutra	acerca#de+esta+outra	S+DFS+IFS0	I
acerca#destoutras	acerca#de+estas+outras	S+DFP+IFP0	I
acerca#destoutro	acerca#de+este+outro	S+DMS+IMS0	I
acerca#destoutros	acerca#de+estes+outros	S+DMP+IMP0	I
acerca#diso	acerca#de+iso	S+DNS	I
acerca#disto	acerca#de+isto	S+DNS	I
acerca#do	acerca#de+o	S+GMS	I
acerca#dos	acerca#de+os	S+GMP	I
acerca#doutra	acerca#de+outra	S+IFS0	I
acerca#doutras	acerca#de+outras	S+IFP0	I
acerca#doutro	acerca#de+outro	S+IMS0	I
acerca#doutros	acerca#de+outros	S+IMP0	I
acerca#dun	acerca#de+un	S+IMS0	I
acerca#dunha	acerca#de+unha	S+IFS0	I
acerca#dunhas	acerca#de+unhas	S+IFP0	I
acerca#duns	acerca#de+uns	S+IMP0	I
ademais#da	ademais#de+a	S+GFS	I
ademais#dalgún	ademais#de+algún	S+IMS0	I
ademais#dalgúns	ademais#de+algúns	S+IMP0	I
ademais#dalgunha	ademais#de+algunha	S+IFS0	I
ademais#dalgunhas	ademais#de+algunhas	S+IFP0	I
ademais#daquel	ademais#de+aquel	S+DMS	I
ademais#daquela	ademais#de+aquela	S+DFS	I
ademais#daquelas	ademais#de+aquelas	S+DFP	I
ademais#daqueles	ademais#de+aqueles	S+DMP	I
ademais#daqueloutra	ademais#de+aquela+outra	S+DFS+IFS0	I
ademais#daqueloutras	ademais#de+aquelas+outras	S+DFP+IFP0	I
ademais#daqueloutro	ademais#de+aquel+outro	S+DMS+IMS0	I
ademais#daqueloutros	ademais#de+aqueles+outros	S+DMP+IMP0	I
ademais#daquilo	ademais#de+aquilo	S+DNS	I
ademais#das	ademais#de+as	S+GFP	I
ademais#de	ademais#de	S	I
ademais#del	ademais#de+el	S+P3MSB0	I
ademais#dela	ademais#de+ela	S+P3FSB0	I
ademais#delas	ademais#de+elas	S+P3FPB0	I
ademais#deles	ademais#de+eles	S+P3MPB0	I
ademais#desa	ademais#de+esa	S+DFS	I
ademais#desas	ademais#de+esas	S+DFP	I
ademais#dese	ademais#de+ese	S+DMS	I
ademais#deses	ademais#de+eses	S+DMP	I
ademais#desoutra	ademais#de+esa+outra	S+DFS+IFS0	I
ademais#desoutras	ademais#de+esas+outras	S+DFP+IFP0	I
ademais#desoutro	ademais#de+ese+outro	S+DMS+IMS0	I
ademais#desoutros	ademais#de+eses+outros	S+DMP+IMP0	I
ademais#desta	ademais#de+esta	S+DFS	I
ademais#destas	ademais#de+estas	S+DFP	I
ademais#deste	ademais#de+este	S+DMS	I
ademais#destes	ademais#de+estes	S+DMP	I
ademais#destoutra	ademais#de+esta+outra	S+DFS+IFS0	I
ademais#destoutras	ademais#de+estas+outras	S+DFP+IFP0	I
ademais#destoutro	ademais#de+este+outro	S+DMS+IMS0	I
ademais#destoutros	ademais#de+estes+outros	S+DMP+IMP0	I
ademais#diso	ademais#de+iso	S+DNS	I
ademais#disto	ademais#de+isto	S+DNS	I
ademais#do	ademais#de+o	S+GMS	I
ademais#dos	ademais#de+os	S+GMP	I
ademais#doutra	ademais#de+outra	S+IFS0	I
ademais#doutras	ademais#de+outras	S+IFP0	I
ademais#doutro	ademais#de+outro	S+IMS0	I
ademais#doutros	ademais#de+outros	S+IMP0	I
ademais#dun	ademais#de+un	S+IMS0	I
ademais#dunha	ademais#de+unha	S+IFS0	I
ademais#dunhas	ademais#de+unhas	S+IFP0	I
ademais#duns	ademais#de+uns	S+IMP0	I
alén#da	alén#de+a	S+GFS	I
alén#dalgún	alén#de+algún	S+IMS0	I
alén#dalgúns	alén#de+algúns	S+IMP0	I
alén#dalgunha	alén#de+algunha	S+IFS0	I
alén#dalgunhas	alén#de+algunhas	S+IFP0	I
alén#daquel	alén#de+aquel	S+DMS	I
alén#daquela	alén#de+aquela	S+DFS	I
alén#daquelas	alén#de+aquelas	S+DFP	I
alén#daqueles	alén#de+aqueles	S+DMP	I
alén#daqueloutra	alén#de+aquela+outra	S+DFS+IFS0	I
alén#daqueloutras	alén#de+aquelas+outras	S+DFP+IFP0	I
alén#daqueloutro	alén#de+aquel+outro	S+DMS+IMS0	I
alén#daqueloutros	alén#de+aqueles+outros	S+DMP+IMP0	I
alén#daquilo	alén#de+aquilo	S+DNS	I
alén#das	alén#de+as	S+GFP	I
alén#de	alén#de	S	I
alén#del	alén#de+el	S+P3MSB0	I
alén#dela	alén#de+ela	S+P3FSB0	I
alén#delas	alén#de+elas	S+P3FPB0	I
alén#deles	alén#de+eles	S+P3MPB0	I
alén#desa	alén#de+esa	S+DFS	I
alén#desas	alén#de+esas	S+DFP	I
alén#dese	alén#de+ese	S+DMS	I
alén#deses	alén#de+eses	S+DMP	I
alén#desoutra	alén#de+esa+outra	S+DFS+IFS0	I
alén#desoutras	alén#de+esas+outras	S+DFP+IFP0	I
alén#desoutro	alén#de+ese+outro	S+DMS+IMS0	I
alén#desoutros	alén#de+eses+outros	S+DMP+IMP0	I
alén#desta	alén#de+esta	S+DFS	I
alén#destas	alén#de+estas	S+DFP	I
alén#deste	alén#de+este	S+DMS	I
alén#destes	alén#de+estes	S+DMP	I
alén#destoutra	alén#de+esta+outra	S+DFS+IFS0	I
alén#destoutras	alén#de+estas+outras	S+DFP+IFP0	I
alén#destoutro	alén#de+este+outro	S+DMS+IMS0	I
alén#destoutros	alén#de+estes+outros	S+DMP+IMP0	I
alén#diso	alén#de+iso	S+DNS	I
alén#disto	alén#de+isto	S+DNS	I
alén#do	alén#de+o	S+GMS	I
alén#dos	alén#de+os	S+GMP	I
alén#doutra	alén#de+outra	S+IFS0	I
alén#doutras	alén#de+outras	S+IFP0	I
alén#doutro	alén#de+outro	S+IMS0	I
alén#doutros	alén#de+outros	S+IMP0	I
alén#dun	alén#de+un	S+IMS0	I
alén#dunha	alén#de+unha	S+IFS0	I
alén#dunhas	alén#de+unhas	S+IFP0	I
alén#duns	alén#de+uns	S+IMP0	I
amais#da	amais#de+a	S+GFS	I
amais#dalgún	amais#de+algún	S+IMS0	I
amais#dalgúns	amais#de+algúns	S+IMP0	I
amais#dalgunha	amais#de+algunha	S+IFS0	I
amais#dalgunhas	amais#de+algunhas	S+IFP0	I
amais#daquel	amais#de+aquel	S+DMS	I
amais#daquela	amais#de+aquela	S+DFS	I
amais#daquelas	amais#de+aquelas	S+DFP	I
amais#daqueles	amais#de+aqueles	S+DMP	I
amais#daqueloutra	amais#de+aquela+outra	S+DFS+IFS0	I
amais#daqueloutras	amais#de+aquelas+outras	S+DFP+IFP0	I
amais#daqueloutro	amais#de+aquel+outro	S+DMS+IMS0	I
amais#daqueloutros	amais#de+aqueles+outros	S+DMP+IMP0	I
amais#daquilo	amais#de+aquilo	S+DNS	I
amais#das	amais#de+as	S+GFP	I
amais#de	amais#de	S	I
amais#del	amais#de+el	S+P3MSB0	I
amais#dela	amais#de+ela	S+P3FSB0	I
amais#delas	amais#de+elas	S+P3FPB0	I
amais#deles	amais#de+eles	S+P3MPB0	I
amais#desa	amais#de+esa	S+DFS	I
amais#desas	amais#de+esas	S+DFP	I
amais#dese	amais#de+ese	S+DMS	I
amais#deses	amais#de+eses	S+DMP	I
amais#desoutra	amais#de+esa+outra	S+DFS+IFS0	I
amais#desoutras	amais#de+esas+outras	S+DFP+IFP0	I
amais#desoutro	amais#de+ese+outro	S+DMS+IMS0	I
amais#desoutros	amais#de+eses+outros	S+DMP+IMP0	I
amais#desta	amais#de+esta	S+DFS	I
amais#destas	amais#de+estas	S+DFP	I
amais#deste	amais#de+este	S+DMS	I
amais#destes	amais#de+estes	S+DMP	I
amais#destoutra	amais#de+esta+outra	S+DFS+IFS0	I
amais#destoutras	amais#de+estas+outras	S+DFP+IFP0	I
amais#destoutro	amais#de+este+outro	S+DMS+IMS0	I
amais#destoutros	amais#de+estes+outros	S+DMP+IMP0	I
amais#diso	amais#de+iso	S+DNS	I
amais#disto	amais#de+isto	S+DNS	I
amais#do	amais#de+o	S+GMS	I
amais#dos	amais#de+os	S+GMP	I
amais#doutra	amais#de+outra	S+IFS0	I
amais#doutras	amais#de+outras	S+IFP0	I
amais#doutro	amais#de+outro	S+IMS0	I
amais#doutros	amais#de+outros	S+IMP0	I
amais#dun	amais#de+un	S+IMS0	I
amais#dunha	amais#de+unha	S+IFS0	I
amais#dunhas	amais#de+unhas	S+IFP0	I
amais#duns	amais#de+uns	S+IMP0	I
antes#da	antes#de+a	S+GFS	I
antes#dalgún	antes#de+algún	S+IMS0	I
antes#dalgúns	antes#de+algúns	S+IMP0	I
antes#dalgunha	antes#de+algunha	S+IFS0	I
antes#dalgunhas	antes#de+algunhas	S+IFP0	I
antes#daquel	antes#de+aquel	S+DMS	I
antes#daquela	antes#de+aquela	S+DFS	I
antes#daquelas	antes#de+aquelas	S+DFP	I
antes#daqueles	antes#de+aqueles	S+DMP	I
antes#daqueloutra	antes#de+aquela+outra	S+DFS+IFS0	I
antes#daqueloutras	antes#de+aquelas+outras	S+DFP+IFP0	I
antes#daqueloutro	antes#de+aquel+outro	S+DMS+IMS0	I
antes#daqueloutros	antes#de+aqueles+outros	S+DMP+IMP0	I
antes#daquilo	antes#de+aquilo	S+DNS	I
antes#das	antes#de+as	S+GFP	I
antes#de	antes#de	S	I
antes#del	antes#de+el	S+P3MSB0	I
antes#dela	antes#de+ela	S+P3FSB0	I
antes#delas	antes#de+elas	S+P3FPB0	I
antes#deles	antes#de+eles	S+P3MPB0	I
antes#desa	antes#de+esa	S+DFS	I
antes#desas	antes#de+esas	S+DFP	I
antes#dese	antes#de+ese	S+DMS	I
antes#deses	antes#de+eses	S+DMP	I
antes#desoutra	antes#de+esa+outra	S+DFS+IFS0	I
antes#desoutras	antes#de+esas+outras	S+DFP+IFP0	I
antes#desoutro	antes#de+ese+outro	S+DMS+IMS0	I
antes#desoutros	antes#de+eses+outros	S+DMP+IMP0	I
antes#desta	antes#de+esta	S+DFS	I
antes#destas	antes#de+estas	S+DFP	I
antes#deste	antes#de+este	S+DMS	I
antes#destes	antes#de+estes	S+DMP	I
antes#destoutra	antes#de+esta+outra	S+DFS+IFS0	I
antes#destoutras	antes#de+estas+outras	S+DFP+IFP0	I
antes#destoutro	antes#de+este+outro	S+DMS+IMS0	I
antes#destoutros	antes#de+estes+outros	S+DMP+IMP0	I
antes#diso	antes#de+iso	S+DNS	I
antes#disto	antes#de+isto	S+DNS	I
antes#do	antes#de+o	S+GMS	I
antes#dos	antes#de+os	S+GMP	I
antes#doutra	antes#de+outra	S+IFS0	I
antes#doutras	antes#de+outras	S+IFP0	I
antes#doutro	antes#de+outro	S+IMS0	I
antes#doutros	antes#de+outros	S+IMP0	I
antes#dun	antes#de+un	S+IMS0	I
antes#dunha	antes#de+unha	S+IFS0	I
antes#dunhas	antes#de+unhas	S+IFP0	I
antes#duns	antes#de+uns	S+IMP0	I
ao#lado#da	ao#lado#de+a	S+GFS	I
ao#lado#dalgún	ao#lado#de+algún	S+IMS0	I
ao#lado#dalgúns	ao#lado#de+algúns	S+IMP0	I
ao#lado#dalgunha	ao#lado#de+algunha	S+IFS0	I
ao#lado#dalgunhas	ao#lado#de+algunhas	S+IFP0	I
ao#lado#daquel	ao#lado#de+aquel	S+DMS	I
ao#lado#daquela	ao#lado#de+aquela	S+DFS	I
ao#lado#daquelas	ao#lado#de+aquelas	S+DFP	I
ao#lado#daqueles	ao#lado#de+aqueles	S+DMP	I
ao#lado#daqueloutra	ao#lado#de+aquela+outra	S+DFS+IFS0	I
ao#lado#daqueloutras	ao#lado#de+aquelas+outras	S+DFP+IFP0	I
ao#lado#daqueloutro	ao#lado#de+aquel+outro	S+DMS+IMS0	I
ao#lado#daqueloutros	ao#lado#de+aqueles+outros	S+DMP+IMP0	I
ao#lado#daquilo	ao#lado#de+aquilo	S+DNS	I
ao#lado#das	ao#lado#de+as	S+GFP	I
ao#lado#de	ao#lado#de	S	I
ao#lado#del	ao#lado#de+el	S+P3MSB0	I
ao#lado#dela	ao#lado#de+ela	S+P3FSB0	I
ao#lado#delas	ao#lado#de+elas	S+P3FPB0	I
ao#lado#deles	ao#lado#de+eles	S+P3MPB0	I
ao#lado#desa	ao#lado#de+esa	S+DFS	I
ao#lado#desas	ao#lado#de+esas	S+DFP	I
ao#lado#dese	ao#lado#de+ese	S+DMS	I
ao#lado#deses	ao#lado#de+eses	S+DMP	I
ao#lado#desoutra	ao#lado#de+esa+outra	S+DFS+IFS0	I
ao#lado#desoutras	ao#lado#de+esas+outras	S+DFP+IFP0	I
ao#lado#desoutro	ao#lado#de+ese+outro	S+DMS+IMS0	I
ao#lado#desoutros	ao#lado#de+eses+outros	S+DMP+IMP0	I
ao#lado#desta	ao#lado#de+esta	S+DFS	I
ao#lado#destas	ao#lado#de+estas	S+DFP	I
ao#lado#deste	ao#lado#de+este	S+DMS	I
ao#lado#destes	ao#lado#de+estes	S+DMP	I
ao#lado#destoutra	ao#lado#de+esta+outra	S+DFS+IFS0	I
ao#lado#destoutras	ao#lado#de+estas+outras	S+DFP+IFP0	I
ao#lado#destoutro	ao#lado#de+este+outro	S+DMS+IMS0	I
ao#lado#destoutros	ao#lado#de+estes+outros	S+DMP+IMP0	I
ao#lado#diso	ao#lado#de+iso	S+DNS	I
ao#lado#disto	ao#lado#de+isto	S+DNS	I
ao#lado#do	ao#lado#de+o	S+GMS	I
ao#lado#dos	ao#lado#de+os	S+GMP	I
ao#lado#doutra	ao#lado#de+outra	S+IFS0	I
ao#lado#doutras	ao#lado#de+outras	S+IFP0	I
ao#lado#doutro	ao#lado#de+outro	S+IMS0	I
ao#lado#doutros	ao#lado#de+outros	S+IMP0	I
ao#lado#dun	ao#lado#de+un	S+IMS0	I
ao#lado#dunha	ao#lado#de+unha	S+IFS0	I
ao#lado#dunhas	ao#lado#de+unhas	S+IFP0	I
ao#lado#duns	ao#lado#de+uns	S+IMP0	I
ao#pé#da	ao#pé#de+a	S+GFS	I
ao#pé#dalgún	ao#pé#de+algún	S+IMS0	I
ao#pé#dalgúns	ao#pé#de+algúns	S+IMP0	I
ao#pé#dalgunha	ao#pé#de+algunha	S+IFS0	I
ao#pé#dalgunhas	ao#pé#de+algunhas	S+IFP0	I
ao#pé#daquel	ao#pé#de+aquel	S+DMS	I
ao#pé#daquela	ao#pé#de+aquela	S+DFS	I
ao#pé#daquelas	ao#pé#de+aquelas	S+DFP	I
ao#pé#daqueles	ao#pé#de+aqueles	S+DMP	I
ao#pé#daqueloutra	ao#pé#de+aquela+outra	S+DFS+IFS0	I
ao#pé#daqueloutras	ao#pé#de+aquelas+outras	S+DFP+IFP0	I
ao#pé#daqueloutro	ao#pé#de+aquel+outro	S+DMS+IMS0	I
ao#pé#daqueloutros	ao#pé#de+aqueles+outros	S+DMP+IMP0	I
ao#pé#daquilo	ao#pé#de+aquilo	S+DNS	I
ao#pé#das	ao#pé#de+as	S+GFP	I
ao#pé#de	ao#pé#de	S	I
ao#pé#del	ao#pé#de+el	S+P3MSB0	I
ao#pé#dela	ao#pé#de+ela	S+P3FSB0	I
ao#pé#delas	ao#pé#de+elas	S+P3FPB0	I
ao#pé#deles	ao#pé#de+eles	S+P3MPB0	I
ao#pé#desa	ao#pé#de+esa	S+DFS	I
ao#pé#desas	ao#pé#de+esas	S+DFP	I
ao#pé#dese	ao#pé#de+ese	S+DMS	I
ao#pé#deses	ao#pé#de+eses	S+DMP	I
ao#pé#desoutra	ao#pé#de+esa+outra	S+DFS+IFS0	I
ao#pé#desoutras	ao#pé#de+esas+outras	S+DFP+IFP0	I
ao#pé#desoutro	ao#pé#de+ese+outro	S+DMS+IMS0	I
ao#pé#desoutros	ao#pé#de+eses+outros	S+DMP+IMP0	I
ao#pé#desta	ao#pé#de+esta	S+DFS	I
ao#pé#destas	ao#pé#de+estas	S+DFP	I
ao#pé#deste	ao#pé#de+este	S+DMS	I
ao#pé#destes	ao#pé#de+estes	S+DMP	I
ao#pé#destoutra	ao#pé#de+esta+outra	S+DFS+IFS0	I
ao#pé#destoutras	ao#pé#de+estas+outras	S+DFP+IFP0	I
ao#pé#destoutro	ao#pé#de+este+outro	S+DMS+IMS0	I
ao#pé#destoutros	ao#pé#de+estes+outros	S+DMP+IMP0	I
ao#pé#diso	ao#pé#de+iso	S+DNS	I
ao#pé#disto	ao#pé#de+isto	S+DNS	I
ao#pé#do	ao#pé#de+o	S+GMS	I
ao#pé#dos	ao#pé#de+os	S+GMP	I
ao#pé#doutra	ao#pé#de+outra	S+IFS0	I
ao#pé#doutras	ao#pé#de+outras	S+IFP0	I
ao#pé#doutro	ao#pé#de+outro	S+IMS0	I
ao#pé#doutros	ao#pé#de+outros	S+IMP0	I
ao#pé#dun	ao#pé#de+un	S+IMS0	I
ao#pé#dunha	ao#pé#de+unha	S+IFS0	I
ao#pé#dunhas	ao#pé#de+unhas	S+IFP0	I
ao#pé#duns	ao#pé#de+uns	S+IMP0	I
ao#par#da	ao#par#de+a	S+GFS	I
ao#par#dalgún	ao#par#de+algún	S+IMS0	I
ao#par#dalgúns	ao#par#de+algúns	S+IMP0	I
ao#par#dalgunha	ao#par#de+algunha	S+IFS0	I
ao#par#dalgunhas	ao#par#de+algunhas	S+IFP0	I
ao#par#daquel	ao#par#de+aquel	S+DMS	I
ao#par#daquela	ao#par#de+aquela	S+DFS	I
ao#par#daquelas	ao#par#de+aquelas	S+DFP	I
ao#par#daqueles	ao#par#de+aqueles	S+DMP	I
ao#par#daqueloutra	ao#par#de+aquela+outra	S+DFS+IFS0	I
ao#par#daqueloutras	ao#par#de+aquelas+outras	S+DFP+IFP0	I
ao#par#daqueloutro	ao#par#de+aquel+outro	S+DMS+IMS0	I
ao#par#daqueloutros	ao#par#de+aqueles+outros	S+DMP+IMP0	I
ao#par#daquilo	ao#par#de+aquilo	S+DNS	I
ao#par#das	ao#par#de+as	S+GFP	I
ao#par#de	ao#par#de	S	I
ao#par#del	ao#par#de+el	S+P3MSB0	I
ao#par#dela	ao#par#de+ela	S+P3FSB0	I
ao#par#delas	ao#par#de+elas	S+P3FPB0	I
ao#par#deles	ao#par#de+eles	S+P3MPB0	I
ao#par#desa	ao#par#de+esa	S+DFS	I
ao#par#desas	ao#par#de+esas	S+DFP	I
ao#par#dese	ao#par#de+ese	S+DMS	I
ao#par#deses	ao#par#de+eses	S+DMP	I
ao#par#desoutra	ao#par#de+esa+outra	S+DFS+IFS0	I
ao#par#desoutras	ao#par#de+esas+outras	S+DFP+IFP0	I
ao#par#desoutro	ao#par#de+ese+outro	S+DMS+IMS0	I
ao#par#desoutros	ao#par#de+eses+outros	S+DMP+IMP0	I
ao#par#desta	ao#par#de+esta	S+DFS	I
ao#par#destas	ao#par#de+estas	S+DFP	I
ao#par#deste	ao#par#de+este	S+DMS	I
ao#par#destes	ao#par#de+estes	S+DMP	I
ao#par#destoutra	ao#par#de+esta+outra	S+DFS+IFS0	I
ao#par#destoutras	ao#par#de+estas+outras	S+DFP+IFP0	I
ao#par#destoutro	ao#par#de+este+outro	S+DMS+IMS0	I
ao#par#destoutros	ao#par#de+estes+outros	S+DMP+IMP0	I
ao#par#diso	ao#par#de+iso	S+DNS	I
ao#par#disto	ao#par#de+isto	S+DNS	I
ao#par#do	ao#par#de+o	S+GMS	I
ao#par#dos	ao#par#de+os	S+GMP	I
ao#par#doutra	ao#par#de+outra	S+IFS0	I
ao#par#doutras	ao#par#de+outras	S+IFP0	I
ao#par#doutro	ao#par#de+outro	S+IMS0	I
ao#par#doutros	ao#par#de+outros	S+IMP0	I
ao#par#dun	ao#par#de+un	S+IMS0	I
ao#par#dunha	ao#par#de+unha	S+IFS0	I
ao#par#dunhas	ao#par#de+unhas	S+IFP0	I
ao#par#duns	ao#par#de+uns	S+IMP0	I
ao#redor#da	ao#redor#de+a	S+GFS	I
ao#redor#dalgún	ao#redor#de+algún	S+IMS0	I
ao#redor#dalgúns	ao#redor#de+algúns	S+IMP0	I
ao#redor#dalgunha	ao#redor#de+algunha	S+IFS0	I
ao#redor#dalgunhas	ao#redor#de+algunhas	S+IFP0	I
ao#redor#daquel	ao#redor#de+aquel	S+DMS	I
ao#redor#daquela	ao#redor#de+aquela	S+DFS	I
ao#redor#daquelas	ao#redor#de+aquelas	S+DFP	I
ao#redor#daqueles	ao#redor#de+aqueles	S+DMP	I
ao#redor#daqueloutra	ao#redor#de+aquela+outra	S+DFS+IFS0	I
ao#redor#daqueloutras	ao#redor#de+aquelas+outras	S+DFP+IFP0	I
ao#redor#daqueloutro	ao#redor#de+aquel+outro	S+DMS+IMS0	I
ao#redor#daqueloutros	ao#redor#de+aqueles+outros	S+DMP+IMP0	I
ao#redor#daquilo	ao#redor#de+aquilo	S+DNS	I
ao#redor#das	ao#redor#de+as	S+GFP	I
ao#redor#de	ao#redor#de	S	I
ao#redor#del	ao#redor#de+el	S+P3MSB0	I
ao#redor#dela	ao#redor#de+ela	S+P3FSB0	I
ao#redor#delas	ao#redor#de+elas	S+P3FPB0	I
ao#redor#deles	ao#redor#de+eles	S+P3MPB0	I
ao#redor#desa	ao#redor#de+esa	S+DFS	I
ao#redor#desas	ao#redor#de+esas	S+DFP	I
ao#redor#dese	ao#redor#de+ese	S+DMS	I
ao#redor#deses	ao#redor#de+eses	S+DMP	I
ao#redor#desoutra	ao#redor#de+esa+outra	S+DFS+IFS0	I
ao#redor#desoutras	ao#redor#de+esas+outras	S+DFP+IFP0	I
ao#redor#desoutro	ao#redor#de+ese+outro	S+DMS+IMS0	I
ao#redor#desoutros	ao#redor#de+eses+outros	S+DMP+IMP0	I
ao#redor#desta	ao#redor#de+esta	S+DFS	I
ao#redor#destas	ao#redor#de+estas	S+DFP	I
ao#redor#deste	ao#redor#de+este	S+DMS	I
ao#redor#destes	ao#redor#de+estes	S+DMP	I
ao#redor#destoutra	ao#redor#de+esta+outra	S+DFS+IFS0	I
ao#redor#destoutras	ao#redor#de+estas+outras	S+DFP+IFP0	I
ao#redor#destoutro	ao#redor#de+este+outro	S+DMS+IMS0	I
ao#redor#destoutros	ao#redor#de+estes+outros	S+DMP+IMP0	I
ao#redor#diso	ao#redor#de+iso	S+DNS	I
ao#redor#disto	ao#redor#de+isto	S+DNS	I
ao#redor#do	ao#redor#de+o	S+GMS	I
ao#redor#dos	ao#redor#de+os	S+GMP	I
ao#redor#doutra	ao#redor#de+outra	S+IFS0	I
ao#redor#doutras	ao#redor#de+outras	S+IFP0	I
ao#redor#doutro	ao#redor#de+outro	S+IMS0	I
ao#redor#doutros	ao#redor#de+outros	S+IMP0	I
ao#redor#dun	ao#redor#de+un	S+IMS0	I
ao#redor#dunha	ao#redor#de+unha	S+IFS0	I
ao#redor#dunhas	ao#redor#de+unhas	S+IFP0	I
ao#redor#duns	ao#redor#de+uns	S+IMP0	I
aquén#da	aquén#de+a	S+GFS	I
aquén#dalgún	aquén#de+algún	S+IMS0	I
aquén#dalgúns	aquén#de+algúns	S+IMP0	I
aquén#dalgunha	aquén#de+algunha	S+IFS0	I
aquén#dalgunhas	aquén#de+algunhas	S+IFP0	I
aquén#daquel	aquén#de+aquel	S+DMS	I
aquén#daquela	aquén#de+aquela	S+DFS	I
aquén#daquelas	aquén#de+aquelas	S+DFP	I
aquén#daqueles	aquén#de+aqueles	S+DMP	I
aquén#daqueloutra	aquén#de+aquela+outra	S+DFS+IFS0	I
aquén#daqueloutras	aquén#de+aquelas+outras	S+DFP+IFP0	I
aquén#daqueloutro	aquén#de+aquel+outro	S+DMS+IMS0	I
aquén#daqueloutros	aquén#de+aqueles+outros	S+DMP+IMP0	I
aquén#daquilo	aquén#de+aquilo	S+DNS	I
aquén#das	aquén#de+as	S+GFP	I
aquén#de	aquén#de	S	I
aquén#del	aquén#de+el	S+P3MSB0	I
aquén#dela	aquén#de+ela	S+P3FSB0	I
aquén#delas	aquén#de+elas	S+P3FPB0	I
aquén#deles	aquén#de+eles	S+P3MPB0	I
aquén#desa	aquén#de+esa	S+DFS	I
aquén#desas	aquén#de+esas	S+DFP	I
aquén#dese	aquén#de+ese	S+DMS	I
aquén#deses	aquén#de+eses	S+DMP	I
aquén#desoutra	aquén#de+esa+outra	S+DFS+IFS0	I
aquén#desoutras	aquén#de+esas+outras	S+DFP+IFP0	I
aquén#desoutro	aquén#de+ese+outro	S+DMS+IMS0	I
aquén#desoutros	aquén#de+eses+outros	S+DMP+IMP0	I
aquén#desta	aquén#de+esta	S+DFS	I
aquén#destas	aquén#de+estas	S+DFP	I
aquén#deste	aquén#de+este	S+DMS	I
aquén#destes	aquén#de+estes	S+DMP	I
aquén#destoutra	aquén#de+esta+outra	S+DFS+IFS0	I
aquén#destoutras	aquén#de+estas+outras	S+DFP+IFP0	I
aquén#destoutro	aquén#de+este+outro	S+DMS+IMS0	I
aquén#destoutros	aquén#de+estes+outros	S+DMP+IMP0	I
aquén#diso	aquén#de+iso	S+DNS	I
aquén#disto	aquén#de+isto	S+DNS	I
aquén#do	aquén#de+o	S+GMS	I
aquén#dos	aquén#de+os	S+GMP	I
aquén#doutra	aquén#de+outra	S+IFS0	I
aquén#doutras	aquén#de+outras	S+IFP0	I
aquén#doutro	aquén#de+outro	S+IMS0	I
aquén#doutros	aquén#de+outros	S+IMP0	I
aquén#dun	aquén#de+un	S+IMS0	I
aquén#dunha	aquén#de+unha	S+IFS0	I
aquén#dunhas	aquén#de+unhas	S+IFP0	I
aquén#duns	aquén#de+uns	S+IMP0	I
arredor#da	arredor#de+a	S+GFS	I
arredor#dalgún	arredor#de+algún	S+IMS0	I
arredor#dalgúns	arredor#de+algúns	S+IMP0	I
arredor#dalgunha	arredor#de+algunha	S+IFS0	I
arredor#dalgunhas	arredor#de+algunhas	S+IFP0	I
arredor#daquel	arredor#de+aquel	S+DMS	I
arredor#daquela	arredor#de+aquela	S+DFS	I
arredor#daquelas	arredor#de+aquelas	S+DFP	I
arredor#daqueles	arredor#de+aqueles	S+DMP	I
arredor#daqueloutra	arredor#de+aquela+outra	S+DFS+IFS0	I
arredor#daqueloutras	arredor#de+aquelas+outras	S+DFP+IFP0	I
arredor#daqueloutro	arredor#de+aquel+outro	S+DMS+IMS0	I
arredor#daqueloutros	arredor#de+aqueles+outros	S+DMP+IMP0	I
arredor#daquilo	arredor#de+aquilo	S+DNS	I
arredor#das	arredor#de+as	S+GFP	I
arredor#de	arredor#de	S	I
arredor#del	arredor#de+el	S+P3MSB0	I
arredor#dela	arredor#de+ela	S+P3FSB0	I
arredor#delas	arredor#de+elas	S+P3FPB0	I
arredor#deles	arredor#de+eles	S+P3MPB0	I
arredor#desa	arredor#de+esa	S+DFS	I
arredor#desas	arredor#de+esas	S+DFP	I
arredor#dese	arredor#de+ese	S+DMS	I
arredor#deses	arredor#de+eses	S+DMP	I
arredor#desoutra	arredor#de+esa+outra	S+DFS+IFS0	I
arredor#desoutras	arredor#de+esas+outras	S+DFP+IFP0	I
arredor#desoutro	arredor#de+ese+outro	S+DMS+IMS0	I
arredor#desoutros	arredor#de+eses+outros	S+DMP+IMP0	I
arredor#desta	arredor#de+esta	S+DFS	I
arredor#destas	arredor#de+estas	S+DFP	I
arredor#deste	arredor#de+este	S+DMS	I
arredor#destes	arredor#de+estes	S+DMP	I
arredor#destoutra	arredor#de+esta+outra	S+DFS+IFS0	I
arredor#destoutras	arredor#de+estas+outras	S+DFP+IFP0	I
arredor#destoutro	arredor#de+este+outro	S+DMS+IMS0	I
arredor#destoutros	arredor#de+estes+outros	S+DMP+IMP0	I
arredor#diso	arredor#de+iso	S+DNS	I
arredor#disto	arredor#de+isto	S+DNS	I
arredor#do	arredor#de+o	S+GMS	I
arredor#dos	arredor#de+os	S+GMP	I
arredor#doutra	arredor#de+outra	S+IFS0	I
arredor#doutras	arredor#de+outras	S+IFP0	I
arredor#doutro	arredor#de+outro	S+IMS0	I
arredor#doutros	arredor#de+outros	S+IMP0	I
arredor#dun	arredor#de+un	S+IMS0	I
arredor#dunha	arredor#de+unha	S+IFS0	I
arredor#dunhas	arredor#de+unhas	S+IFP0	I
arredor#duns	arredor#de+uns	S+IMP0	I
arriba#da	arriba#de+a	S+GFS	I
arriba#dalgún	arriba#de+algún	S+IMS0	I
arriba#dalgúns	arriba#de+algúns	S+IMP0	I
arriba#dalgunha	arriba#de+algunha	S+IFS0	I
arriba#dalgunhas	arriba#de+algunhas	S+IFP0	I
arriba#daquel	arriba#de+aquel	S+DMS	I
arriba#daquela	arriba#de+aquela	S+DFS	I
arriba#daquelas	arriba#de+aquelas	S+DFP	I
arriba#daqueles	arriba#de+aqueles	S+DMP	I
arriba#daqueloutra	arriba#de+aquela+outra	S+DFS+IFS0	I
arriba#daqueloutras	arriba#de+aquelas+outras	S+DFP+IFP0	I
arriba#daqueloutro	arriba#de+aquel+outro	S+DMS+IMS0	I
arriba#daqueloutros	arriba#de+aqueles+outros	S+DMP+IMP0	I
arriba#daquilo	arriba#de+aquilo	S+DNS	I
arriba#das	arriba#de+as	S+GFP	I
arriba#de	arriba#de	S	I
arriba#del	arriba#de+el	S+P3MSB0	I
arriba#dela	arriba#de+ela	S+P3FSB0	I
arriba#delas	arriba#de+elas	S+P3FPB0	I
arriba#deles	arriba#de+eles	S+P3MPB0	I
arriba#desa	arriba#de+esa	S+DFS	I
arriba#desas	arriba#de+esas	S+DFP	I
arriba#dese	arriba#de+ese	S+DMS	I
arriba#deses	arriba#de+eses	S+DMP	I
arriba#desoutra	arriba#de+esa+outra	S+DFS+IFS0	I
arriba#desoutras	arriba#de+esas+outras	S+DFP+IFP0	I
arriba#desoutro	arriba#de+ese+outro	S+DMS+IMS0	I
arriba#desoutros	arriba#de+eses+outros	S+DMP+IMP0	I
arriba#desta	arriba#de+esta	S+DFS	I
arriba#destas	arriba#de+estas	S+DFP	I
arriba#deste	arriba#de+este	S+DMS	I
arriba#destes	arriba#de+estes	S+DMP	I
arriba#destoutra	arriba#de+esta+outra	S+DFS+IFS0	I
arriba#destoutras	arriba#de+estas+outras	S+DFP+IFP0	I
arriba#destoutro	arriba#de+este+outro	S+DMS+IMS0	I
arriba#destoutros	arriba#de+estes+outros	S+DMP+IMP0	I
arriba#diso	arriba#de+iso	S+DNS	I
arriba#disto	arriba#de+isto	S+DNS	I
arriba#do	arriba#de+o	S+GMS	I
arriba#dos	arriba#de+os	S+GMP	I
arriba#doutra	arriba#de+outra	S+IFS0	I
arriba#doutras	arriba#de+outras	S+IFP0	I
arriba#doutro	arriba#de+outro	S+IMS0	I
arriba#doutros	arriba#de+outros	S+IMP0	I
arriba#dun	arriba#de+un	S+IMS0	I
arriba#dunha	arriba#de+unha	S+IFS0	I
arriba#dunhas	arriba#de+unhas	S+IFP0	I
arriba#duns	arriba#de+uns	S+IMP0	I
atrás#da	atrás#de+a	S+GFS	I
atrás#dalgún	atrás#de+algún	S+IMS0	I
atrás#dalgúns	atrás#de+algúns	S+IMP0	I
atrás#dalgunha	atrás#de+algunha	S+IFS0	I
atrás#dalgunhas	atrás#de+algunhas	S+IFP0	I
atrás#daquel	atrás#de+aquel	S+DMS	I
atrás#daquela	atrás#de+aquela	S+DFS	I
atrás#daquelas	atrás#de+aquelas	S+DFP	I
atrás#daqueles	atrás#de+aqueles	S+DMP	I
atrás#daqueloutra	atrás#de+aquela+outra	S+DFS+IFS0	I
atrás#daqueloutras	atrás#de+aquelas+outras	S+DFP+IFP0	I
atrás#daqueloutro	atrás#de+aquel+outro	S+DMS+IMS0	I
atrás#daqueloutros	atrás#de+aqueles+outros	S+DMP+IMP0	I
atrás#daquilo	atrás#de+aquilo	S+DNS	I
atrás#das	atrás#de+as	S+GFP	I
atrás#de	atrás#de	S	I
atrás#del	atrás#de+el	S+P3MSB0	I
atrás#dela	atrás#de+ela	S+P3FSB0	I
atrás#delas	atrás#de+elas	S+P3FPB0	I
atrás#deles	atrás#de+eles	S+P3MPB0	I
atrás#desa	atrás#de+esa	S+DFS	I
atrás#desas	atrás#de+esas	S+DFP	I
atrás#dese	atrás#de+ese	S+DMS	I
atrás#deses	atrás#de+eses	S+DMP	I
atrás#desoutra	atrás#de+esa+outra	S+DFS+IFS0	I
atrás#desoutras	atrás#de+esas+outras	S+DFP+IFP0	I
atrás#desoutro	atrás#de+ese+outro	S+DMS+IMS0	I
atrás#desoutros	atrás#de+eses+outros	S+DMP+IMP0	I
atrás#desta	atrás#de+esta	S+DFS	I
atrás#destas	atrás#de+estas	S+DFP	I
atrás#deste	atrás#de+este	S+DMS	I
atrás#destes	atrás#de+estes	S+DMP	I
atrás#destoutra	atrás#de+esta+outra	S+DFS+IFS0	I
atrás#destoutras	atrás#de+estas+outras	S+DFP+IFP0	I
atrás#destoutro	atrás#de+este+outro	S+DMS+IMS0	I
atrás#destoutros	atrás#de+estes+outros	S+DMP+IMP0	I
atrás#diso	atrás#de+iso	S+DNS	I
atrás#disto	atrás#de+isto	S+DNS	I
atrás#do	atrás#de+o	S+GMS	I
atrás#dos	atrás#de+os	S+GMP	I
atrás#doutra	atrás#de+outra	S+IFS0	I
atrás#doutras	atrás#de+outras	S+IFP0	I
atrás#doutro	atrás#de+outro	S+IMS0	I
atrás#doutros	atrás#de+outros	S+IMP0	I
atrás#dun	atrás#de+un	S+IMS0	I
atrás#dunha	atrás#de+unha	S+IFS0	I
atrás#dunhas	atrás#de+unhas	S+IFP0	I
atrás#duns	atrás#de+uns	S+IMP0	I
baixo#da	baixo#de+a	S+GFS	I
baixo#dalgún	baixo#de+algún	S+IMS0	I
baixo#dalgúns	baixo#de+algúns	S+IMP0	I
baixo#dalgunha	baixo#de+algunha	S+IFS0	I
baixo#dalgunhas	baixo#de+algunhas	S+IFP0	I
baixo#daquel	baixo#de+aquel	S+DMS	I
baixo#daquela	baixo#de+aquela	S+DFS	I
baixo#daquelas	baixo#de+aquelas	S+DFP	I
baixo#daqueles	baixo#de+aqueles	S+DMP	I
baixo#daqueloutra	baixo#de+aquela+outra	S+DFS+IFS0	I
baixo#daqueloutras	baixo#de+aquelas+outras	S+DFP+IFP0	I
baixo#daqueloutro	baixo#de+aquel+outro	S+DMS+IMS0	I
baixo#daqueloutros	baixo#de+aqueles+outros	S+DMP+IMP0	I
baixo#daquilo	baixo#de+aquilo	S+DNS	I
baixo#das	baixo#de+as	S+GFP	I
baixo#de	baixo#de	S	I
baixo#del	baixo#de+el	S+P3MSB0	I
baixo#dela	baixo#de+ela	S+P3FSB0	I
baixo#delas	baixo#de+elas	S+P3FPB0	I
baixo#deles	baixo#de+eles	S+P3MPB0	I
baixo#desa	baixo#de+esa	S+DFS	I
baixo#desas	baixo#de+esas	S+DFP	I
baixo#dese	baixo#de+ese	S+DMS	I
baixo#deses	baixo#de+eses	S+DMP	I
baixo#desoutra	baixo#de+esa+outra	S+DFS+IFS0	I
baixo#desoutras	baixo#de+esas+outras	S+DFP+IFP0	I
baixo#desoutro	baixo#de+ese+outro	S+DMS+IMS0	I
baixo#desoutros	baixo#de+eses+outros	S+DMP+IMP0	I
baixo#desta	baixo#de+esta	S+DFS	I
baixo#destas	baixo#de+estas	S+DFP	I
baixo#deste	baixo#de+este	S+DMS	I
baixo#destes	baixo#de+estes	S+DMP	I
baixo#destoutra	baixo#de+esta+outra	S+DFS+IFS0	I
baixo#destoutras	baixo#de+estas+outras	S+DFP+IFP0	I
baixo#destoutro	baixo#de+este+outro	S+DMS+IMS0	I
baixo#destoutros	baixo#de+estes+outros	S+DMP+IMP0	I
baixo#diso	baixo#de+iso	S+DNS	I
baixo#disto	baixo#de+isto	S+DNS	I
baixo#do	baixo#de+o	S+GMS	I
baixo#dos	baixo#de+os	S+GMP	I
baixo#doutra	baixo#de+outra	S+IFS0	I
baixo#doutras	baixo#de+outras	S+IFP0	I
baixo#doutro	baixo#de+outro	S+IMS0	I
baixo#doutros	baixo#de+outros	S+IMP0	I
baixo#dun	baixo#de+un	S+IMS0	I
baixo#dunha	baixo#de+unha	S+IFS0	I
baixo#dunhas	baixo#de+unhas	S+IFP0	I
baixo#duns	baixo#de+uns	S+IMP0	I
bardante#da	bardante#de+a	S+GFS	I
bardante#dalgún	bardante#de+algún	S+IMS0	I
bardante#dalgúns	bardante#de+algúns	S+IMP0	I
bardante#dalgunha	bardante#de+algunha	S+IFS0	I
bardante#dalgunhas	bardante#de+algunhas	S+IFP0	I
bardante#daquel	bardante#de+aquel	S+DMS	I
bardante#daquela	bardante#de+aquela	S+DFS	I
bardante#daquelas	bardante#de+aquelas	S+DFP	I
bardante#daqueles	bardante#de+aqueles	S+DMP	I
bardante#daqueloutra	bardante#de+aquela+outra	S+DFS+IFS0	I
bardante#daqueloutras	bardante#de+aquelas+outras	S+DFP+IFP0	I
bardante#daqueloutro	bardante#de+aquel+outro	S+DMS+IMS0	I
bardante#daqueloutros	bardante#de+aqueles+outros	S+DMP+IMP0	I
bardante#daquilo	bardante#de+aquilo	S+DNS	I
bardante#das	bardante#de+as	S+GFP	I
bardante#de	bardante#de	S	I
bardante#del	bardante#de+el	S+P3MSB0	I
bardante#dela	bardante#de+ela	S+P3FSB0	I
bardante#delas	bardante#de+elas	S+P3FPB0	I
bardante#deles	bardante#de+eles	S+P3MPB0	I
bardante#desa	bardante#de+esa	S+DFS	I
bardante#desas	bardante#de+esas	S+DFP	I
bardante#dese	bardante#de+ese	S+DMS	I
bardante#deses	bardante#de+eses	S+DMP	I
bardante#desoutra	bardante#de+esa+outra	S+DFS+IFS0	I
bardante#desoutras	bardante#de+esas+outras	S+DFP+IFP0	I
bardante#desoutro	bardante#de+ese+outro	S+DMS+IMS0	I
bardante#desoutros	bardante#de+eses+outros	S+DMP+IMP0	I
bardante#desta	bardante#de+esta	S+DFS	I
bardante#destas	bardante#de+estas	S+DFP	I
bardante#deste	bardante#de+este	S+DMS	I
bardante#destes	bardante#de+estes	S+DMP	I
bardante#destoutra	bardante#de+esta+outra	S+DFS+IFS0	I
bardante#destoutras	bardante#de+estas+outras	S+DFP+IFP0	I
bardante#destoutro	bardante#de+este+outro	S+DMS+IMS0	I
bardante#destoutros	bardante#de+estes+outros	S+DMP+IMP0	I
bardante#diso	bardante#de+iso	S+DNS	I
bardante#disto	bardante#de+isto	S+DNS	I
bardante#do	bardante#de+o	S+GMS	I
bardante#dos	bardante#de+os	S+GMP	I
bardante#doutra	bardante#de+outra	S+IFS0	I
bardante#doutras	bardante#de+outras	S+IFP0	I
bardante#doutro	bardante#de+outro	S+IMS0	I
bardante#doutros	bardante#de+outros	S+IMP0	I
bardante#dun	bardante#de+un	S+IMS0	I
bardante#dunha	bardante#de+unha	S+IFS0	I
bardante#dunhas	bardante#de+unhas	S+IFP0	I
bardante#duns	bardante#de+uns	S+IMP0	I
beira#da	beira#de+a	S+GFS	I
beira#dalgún	beira#de+algún	S+IMS0	I
beira#dalgúns	beira#de+algúns	S+IMP0	I
beira#dalgunha	beira#de+algunha	S+IFS0	I
beira#dalgunhas	beira#de+algunhas	S+IFP0	I
beira#daquel	beira#de+aquel	S+DMS	I
beira#daquela	beira#de+aquela	S+DFS	I
beira#daquelas	beira#de+aquelas	S+DFP	I
beira#daqueles	beira#de+aqueles	S+DMP	I
beira#daqueloutra	beira#de+aquela+outra	S+DFS+IFS0	I
beira#daqueloutras	beira#de+aquelas+outras	S+DFP+IFP0	I
beira#daqueloutro	beira#de+aquel+outro	S+DMS+IMS0	I
beira#daqueloutros	beira#de+aqueles+outros	S+DMP+IMP0	I
beira#daquilo	beira#de+aquilo	S+DNS	I
beira#das	beira#de+as	S+GFP	I
beira#de	beira#de	S	I
beira#del	beira#de+el	S+P3MSB0	I
beira#dela	beira#de+ela	S+P3FSB0	I
beira#delas	beira#de+elas	S+P3FPB0	I
beira#deles	beira#de+eles	S+P3MPB0	I
beira#desa	beira#de+esa	S+DFS	I
beira#desas	beira#de+esas	S+DFP	I
beira#dese	beira#de+ese	S+DMS	I
beira#deses	beira#de+eses	S+DMP	I
beira#desoutra	beira#de+esa+outra	S+DFS+IFS0	I
beira#desoutras	beira#de+esas+outras	S+DFP+IFP0	I
beira#desoutro	beira#de+ese+outro	S+DMS+IMS0	I
beira#desoutros	beira#de+eses+outros	S+DMP+IMP0	I
beira#desta	beira#de+esta	S+DFS	I
beira#destas	beira#de+estas	S+DFP	I
beira#deste	beira#de+este	S+DMS	I
beira#destes	beira#de+estes	S+DMP	I
beira#destoutra	beira#de+esta+outra	S+DFS+IFS0	I
beira#destoutras	beira#de+estas+outras	S+DFP+IFP0	I
beira#destoutro	beira#de+este+outro	S+DMS+IMS0	I
beira#destoutros	beira#de+estes+outros	S+DMP+IMP0	I
beira#diso	beira#de+iso	S+DNS	I
beira#disto	beira#de+isto	S+DNS	I
beira#do	beira#de+o	S+GMS	I
beira#dos	beira#de+os	S+GMP	I
beira#doutra	beira#de+outra	S+IFS0	I
beira#doutras	beira#de+outras	S+IFP0	I
beira#doutro	beira#de+outro	S+IMS0	I
beira#doutros	beira#de+outros	S+IMP0	I
beira#dun	beira#de+un	S+IMS0	I
beira#dunha	beira#de+unha	S+IFS0	I
beira#dunhas	beira#de+unhas	S+IFP0	I
beira#duns	beira#de+uns	S+IMP0	I
cabo#da	cabo#de+a	S+GFS	I
cabo#dalgún	cabo#de+algún	S+IMS0	I
cabo#dalgúns	cabo#de+algúns	S+IMP0	I
cabo#dalgunha	cabo#de+algunha	S+IFS0	I
cabo#dalgunhas	cabo#de+algunhas	S+IFP0	I
cabo#daquel	cabo#de+aquel	S+DMS	I
cabo#daquela	cabo#de+aquela	S+DFS	I
cabo#daquelas	cabo#de+aquelas	S+DFP	I
cabo#daqueles	cabo#de+aqueles	S+DMP	I
cabo#daqueloutra	cabo#de+aquela+outra	S+DFS+IFS0	I
cabo#daqueloutras	cabo#de+aquelas+outras	S+DFP+IFP0	I
cabo#daqueloutro	cabo#de+aquel+outro	S+DMS+IMS0	I
cabo#daqueloutros	cabo#de+aqueles+outros	S+DMP+IMP0	I
cabo#daquilo	cabo#de+aquilo	S+DNS	I
cabo#das	cabo#de+as	S+GFP	I
cabo#de	cabo#de	S	I
cabo#del	cabo#de+el	S+P3MSB0	I
cabo#dela	cabo#de+ela	S+P3FSB0	I
cabo#delas	cabo#de+elas	S+P3FPB0	I
cabo#deles	cabo#de+eles	S+P3MPB0	I
cabo#desa	cabo#de+esa	S+DFS	I
cabo#desas	cabo#de+esas	S+DFP	I
cabo#dese	cabo#de+ese	S+DMS	I
cabo#deses	cabo#de+eses	S+DMP	I
cabo#desoutra	cabo#de+esa+outra	S+DFS+IFS0	I
cabo#desoutras	cabo#de+esas+outras	S+DFP+IFP0	I
cabo#desoutro	cabo#de+ese+outro	S+DMS+IMS0	I
cabo#desoutros	cabo#de+eses+outros	S+DMP+IMP0	I
cabo#desta	cabo#de+esta	S+DFS	I
cabo#destas	cabo#de+estas	S+DFP	I
cabo#deste	cabo#de+este	S+DMS	I
cabo#destes	cabo#de+estes	S+DMP	I
cabo#destoutra	cabo#de+esta+outra	S+DFS+IFS0	I
cabo#destoutras	cabo#de+estas+outras	S+DFP+IFP0	I
cabo#destoutro	cabo#de+este+outro	S+DMS+IMS0	I
cabo#destoutros	cabo#de+estes+outros	S+DMP+IMP0	I
cabo#diso	cabo#de+iso	S+DNS	I
cabo#disto	cabo#de+isto	S+DNS	I
cabo#do	cabo#de+o	S+GMS	I
cabo#dos	cabo#de+os	S+GMP	I
cabo#doutra	cabo#de+outra	S+IFS0	I
cabo#doutras	cabo#de+outras	S+IFP0	I
cabo#doutro	cabo#de+outro	S+IMS0	I
cabo#doutros	cabo#de+outros	S+IMP0	I
cabo#dun	cabo#de+un	S+IMS0	I
cabo#dunha	cabo#de+unha	S+IFS0	I
cabo#dunhas	cabo#de+unhas	S+IFP0	I
cabo#duns	cabo#de+uns	S+IMP0	I
canto#á	canto#a+a	S+GFS	I
canto#ás	canto#a+as	S+GFP	I
canto#ó	canto#a+o	S+GMS	I
canto#a	canto#a	S	I
canto#ao	canto#a+o	S+GMS	I
canto#aos	canto#a+os	S+GMP	I
cara#á	cara#a+a	S+GFS	I
cara#ás	cara#a+as	S+GFP	I
cara#ó	cara#a+o	S+GMS	I
cara#a	cara#a	S	I
cara#ao	cara#a+o	S+GMS	I
cara#aos	cara#a+os	S+GMP	I
cas#da	cas#de+a	S+GFS	I
cas#dalgún	cas#de+algún	S+IMS0	I
cas#dalgúns	cas#de+algúns	S+IMP0	I
cas#dalgunha	cas#de+algunha	S+IFS0	I
cas#dalgunhas	cas#de+algunhas	S+IFP0	I
cas#daquel	cas#de+aquel	S+DMS	I
cas#daquela	cas#de+aquela	S+DFS	I
cas#daquelas	cas#de+aquelas	S+DFP	I
cas#daqueles	cas#de+aqueles	S+DMP	I
cas#daqueloutra	cas#de+aquela+outra	S+DFS+IFS0	I
cas#daqueloutras	cas#de+aquelas+outras	S+DFP+IFP0	I
cas#daqueloutro	cas#de+aquel+outro	S+DMS+IMS0	I
cas#daqueloutros	cas#de+aqueles+outros	S+DMP+IMP0	I
cas#daquilo	cas#de+aquilo	S+DNS	I
cas#das	cas#de+as	S+GFP	I
cas#de	cas#de	S	I
cas#del	cas#de+el	S+P3MSB0	I
cas#dela	cas#de+ela	S+P3FSB0	I
cas#delas	cas#de+elas	S+P3FPB0	I
cas#deles	cas#de+eles	S+P3MPB0	I
cas#desa	cas#de+esa	S+DFS	I
cas#desas	cas#de+esas	S+DFP	I
cas#dese	cas#de+ese	S+DMS	I
cas#deses	cas#de+eses	S+DMP	I
cas#desoutra	cas#de+esa+outra	S+DFS+IFS0	I
cas#desoutras	cas#de+esas+outras	S+DFP+IFP0	I
cas#desoutro	cas#de+ese+outro	S+DMS+IMS0	I
cas#desoutros	cas#de+eses+outros	S+DMP+IMP0	I
cas#desta	cas#de+esta	S+DFS	I
cas#destas	cas#de+estas	S+DFP	I
cas#deste	cas#de+este	S+DMS	I
cas#destes	cas#de+estes	S+DMP	I
cas#destoutra	cas#de+esta+outra	S+DFS+IFS0	I
cas#destoutras	cas#de+estas+outras	S+DFP+IFP0	I
cas#destoutro	cas#de+este+outro	S+DMS+IMS0	I
cas#destoutros	cas#de+estes+outros	S+DMP+IMP0	I
cas#diso	cas#de+iso	S+DNS	I
cas#disto	cas#de+isto	S+DNS	I
cas#do	cas#de+o	S+GMS	I
cas#dos	cas#de+os	S+GMP	I
cas#doutra	cas#de+outra	S+IFS0	I
cas#doutras	cas#de+outras	S+IFP0	I
cas#doutro	cas#de+outro	S+IMS0	I
cas#doutros	cas#de+outros	S+IMP0	I
cas#dun	cas#de+un	S+IMS0	I
cas#dunha	cas#de+unha	S+IFS0	I
cas#dunhas	cas#de+unhas	S+IFP0	I
cas#duns	cas#de+uns	S+IMP0	I
causa#da	causa#de+a	S+GFS	I
causa#dalgún	causa#de+algún	S+IMS0	I
causa#dalgúns	causa#de+algúns	S+IMP0	I
causa#dalgunha	causa#de+algunha	S+IFS0	I
causa#dalgunhas	causa#de+algunhas	S+IFP0	I
causa#daquel	causa#de+aquel	S+DMS	I
causa#daquela	causa#de+aquela	S+DFS	I
causa#daquelas	causa#de+aquelas	S+DFP	I
causa#daqueles	causa#de+aqueles	S+DMP	I
causa#daqueloutra	causa#de+aquela+outra	S+DFS+IFS0	I
causa#daqueloutras	causa#de+aquelas+outras	S+DFP+IFP0	I
causa#daqueloutro	causa#de+aquel+outro	S+DMS+IMS0	I
causa#daqueloutros	causa#de+aqueles+outros	S+DMP+IMP0	I
causa#daquilo	causa#de+aquilo	S+DNS	I
causa#das	causa#de+as	S+GFP	I
causa#de	causa#de	S	I
causa#del	causa#de+el	S+P3MSB0	I
causa#dela	causa#de+ela	S+P3FSB0	I
causa#delas	causa#de+elas	S+P3FPB0	I
causa#deles	causa#de+eles	S+P3MPB0	I
causa#desa	causa#de+esa	S+DFS	I
causa#desas	causa#de+esas	S+DFP	I
causa#dese	causa#de+ese	S+DMS	I
causa#deses	causa#de+eses	S+DMP	I
causa#desoutra	causa#de+esa+outra	S+DFS+IFS0	I
causa#desoutras	causa#de+esas+outras	S+DFP+IFP0	I
causa#desoutro	causa#de+ese+outro	S+DMS+IMS0	I
causa#desoutros	causa#de+eses+outros	S+DMP+IMP0	I
causa#desta	causa#de+esta	S+DFS	I
causa#destas	causa#de+estas	S+DFP	I
causa#deste	causa#de+este	S+DMS	I
causa#destes	causa#de+estes	S+DMP	I
causa#destoutra	causa#de+esta+outra	S+DFS+IFS0	I
causa#destoutras	causa#de+estas+outras	S+DFP+IFP0	I
causa#destoutro	causa#de+este+outro	S+DMS+IMS0	I
causa#destoutros	causa#de+estes+outros	S+DMP+IMP0	I
causa#diso	causa#de+iso	S+DNS	I
causa#disto	causa#de+isto	S+DNS	I
causa#do	causa#de+o	S+GMS	I
causa#dos	causa#de+os	S+GMP	I
causa#doutra	causa#de+outra	S+IFS0	I
causa#doutras	causa#de+outras	S+IFP0	I
causa#doutro	causa#de+outro	S+IMS0	I
causa#doutros	causa#de+outros	S+IMP0	I
causa#dun	causa#de+un	S+IMS0	I
causa#dunha	causa#de+unha	S+IFS0	I
causa#dunhas	causa#de+unhas	S+IFP0	I
causa#duns	causa#de+uns	S+IMP0	I
cerca#da	cerca#de+a	S+GFS	I
cerca#dalgún	cerca#de+algún	S+IMS0	I
cerca#dalgúns	cerca#de+algúns	S+IMP0	I
cerca#dalgunha	cerca#de+algunha	S+IFS0	I
cerca#dalgunhas	cerca#de+algunhas	S+IFP0	I
cerca#daquel	cerca#de+aquel	S+DMS	I
cerca#daquela	cerca#de+aquela	S+DFS	I
cerca#daquelas	cerca#de+aquelas	S+DFP	I
cerca#daqueles	cerca#de+aqueles	S+DMP	I
cerca#daqueloutra	cerca#de+aquela+outra	S+DFS+IFS0	I
cerca#daqueloutras	cerca#de+aquelas+outras	S+DFP+IFP0	I
cerca#daqueloutro	cerca#de+aquel+outro	S+DMS+IMS0	I
cerca#daqueloutros	cerca#de+aqueles+outros	S+DMP+IMP0	I
cerca#daquilo	cerca#de+aquilo	S+DNS	I
cerca#das	cerca#de+as	S+GFP	I
cerca#de	cerca#de	S	I
cerca#del	cerca#de+el	S+P3MSB0	I
cerca#dela	cerca#de+ela	S+P3FSB0	I
cerca#delas	cerca#de+elas	S+P3FPB0	I
cerca#deles	cerca#de+eles	S+P3MPB0	I
cerca#desa	cerca#de+esa	S+DFS	I
cerca#desas	cerca#de+esas	S+DFP	I
cerca#dese	cerca#de+ese	S+DMS	I
cerca#deses	cerca#de+eses	S+DMP	I
cerca#desoutra	cerca#de+esa+outra	S+DFS+IFS0	I
cerca#desoutras	cerca#de+esas+outras	S+DFP+IFP0	I
cerca#desoutro	cerca#de+ese+outro	S+DMS+IMS0	I
cerca#desoutros	cerca#de+eses+outros	S+DMP+IMP0	I
cerca#desta	cerca#de+esta	S+DFS	I
cerca#destas	cerca#de+estas	S+DFP	I
cerca#deste	cerca#de+este	S+DMS	I
cerca#destes	cerca#de+estes	S+DMP	I
cerca#destoutra	cerca#de+esta+outra	S+DFS+IFS0	I
cerca#destoutras	cerca#de+estas+outras	S+DFP+IFP0	I
cerca#destoutro	cerca#de+este+outro	S+DMS+IMS0	I
cerca#destoutros	cerca#de+estes+outros	S+DMP+IMP0	I
cerca#diso	cerca#de+iso	S+DNS	I
cerca#disto	cerca#de+isto	S+DNS	I
cerca#do	cerca#de+o	S+GMS	I
cerca#dos	cerca#de+os	S+GMP	I
cerca#doutra	cerca#de+outra	S+IFS0	I
cerca#doutras	cerca#de+outras	S+IFP0	I
cerca#doutro	cerca#de+outro	S+IMS0	I
cerca#doutros	cerca#de+outros	S+IMP0	I
cerca#dun	cerca#de+un	S+IMS0	I
cerca#dunha	cerca#de+unha	S+IFS0	I
cerca#dunhas	cerca#de+unhas	S+IFP0	I
cerca#duns	cerca#de+uns	S+IMP0	I
cima#da	cima#de+a	S+GFS	I
cima#dalgún	cima#de+algún	S+IMS0	I
cima#dalgúns	cima#de+algúns	S+IMP0	I
cima#dalgunha	cima#de+algunha	S+IFS0	I
cima#dalgunhas	cima#de+algunhas	S+IFP0	I
cima#daquel	cima#de+aquel	S+DMS	I
cima#daquela	cima#de+aquela	S+DFS	I
cima#daquelas	cima#de+aquelas	S+DFP	I
cima#daqueles	cima#de+aqueles	S+DMP	I
cima#daqueloutra	cima#de+aquela+outra	S+DFS+IFS0	I
cima#daqueloutras	cima#de+aquelas+outras	S+DFP+IFP0	I
cima#daqueloutro	cima#de+aquel+outro	S+DMS+IMS0	I
cima#daqueloutros	cima#de+aqueles+outros	S+DMP+IMP0	I
cima#daquilo	cima#de+aquilo	S+DNS	I
cima#das	cima#de+as	S+GFP	I
cima#de	cima#de	S	I
cima#del	cima#de+el	S+P3MSB0	I
cima#dela	cima#de+ela	S+P3FSB0	I
cima#delas	cima#de+elas	S+P3FPB0	I
cima#deles	cima#de+eles	S+P3MPB0	I
cima#desa	cima#de+esa	S+DFS	I
cima#desas	cima#de+esas	S+DFP	I
cima#dese	cima#de+ese	S+DMS	I
cima#deses	cima#de+eses	S+DMP	I
cima#desoutra	cima#de+esa+outra	S+DFS+IFS0	I
cima#desoutras	cima#de+esas+outras	S+DFP+IFP0	I
cima#desoutro	cima#de+ese+outro	S+DMS+IMS0	I
cima#desoutros	cima#de+eses+outros	S+DMP+IMP0	I
cima#desta	cima#de+esta	S+DFS	I
cima#destas	cima#de+estas	S+DFP	I
cima#deste	cima#de+este	S+DMS	I
cima#destes	cima#de+estes	S+DMP	I
cima#destoutra	cima#de+esta+outra	S+DFS+IFS0	I
cima#destoutras	cima#de+estas+outras	S+DFP+IFP0	I
cima#destoutro	cima#de+este+outro	S+DMS+IMS0	I
cima#destoutros	cima#de+estes+outros	S+DMP+IMP0	I
cima#diso	cima#de+iso	S+DNS	I
cima#disto	cima#de+isto	S+DNS	I
cima#do	cima#de+o	S+GMS	I
cima#dos	cima#de+os	S+GMP	I
cima#doutra	cima#de+outra	S+IFS0	I
cima#doutras	cima#de+outras	S+IFP0	I
cima#doutro	cima#de+outro	S+IMS0	I
cima#doutros	cima#de+outros	S+IMP0	I
cima#dun	cima#de+un	S+IMS0	I
cima#dunha	cima#de+unha	S+IFS0	I
cima#dunhas	cima#de+unhas	S+IFP0	I
cima#duns	cima#de+uns	S+IMP0	I
co#gallo#da	co#gallo#de+a	S+GFS	I
co#gallo#dalgún	co#gallo#de+algún	S+IMS0	I
co#gallo#dalgúns	co#gallo#de+algúns	S+IMP0	I
co#gallo#dalgunha	co#gallo#de+algunha	S+IFS0	I
co#gallo#dalgunhas	co#gallo#de+algunhas	S+IFP0	I
co#gallo#daquel	co#gallo#de+aquel	S+DMS	I
co#gallo#daquela	co#gallo#de+aquela	S+DFS	I
co#gallo#daquelas	co#gallo#de+aquelas	S+DFP	I
co#gallo#daqueles	co#gallo#de+aqueles	S+DMP	I
co#gallo#daqueloutra	co#gallo#de+aquela+outra	S+DFS+IFS0	I
co#gallo#daqueloutras	co#gallo#de+aquelas+outras	S+DFP+IFP0	I
co#gallo#daqueloutro	co#gallo#de+aquel+outro	S+DMS+IMS0	I
co#gallo#daqueloutros	co#gallo#de+aqueles+outros	S+DMP+IMP0	I
co#gallo#daquilo	co#gallo#de+aquilo	S+DNS	I
co#gallo#das	co#gallo#de+as	S+GFP	I
co#gallo#de	co#gallo#de	S	I
co#gallo#del	co#gallo#de+el	S+P3MSB0	I
co#gallo#dela	co#gallo#de+ela	S+P3FSB0	I
co#gallo#delas	co#gallo#de+elas	S+P3FPB0	I
co#gallo#deles	co#gallo#de+eles	S+P3MPB0	I
co#gallo#desa	co#gallo#de+esa	S+DFS	I
co#gallo#desas	co#gallo#de+esas	S+DFP	I
co#gallo#dese	co#gallo#de+ese	S+DMS	I
co#gallo#deses	co#gallo#de+eses	S+DMP	I
co#gallo#desoutra	co#gallo#de+esa+outra	S+DFS+IFS0	I
co#gallo#desoutras	co#gallo#de+esas+outras	S+DFP+IFP0	I
co#gallo#desoutro	co#gallo#de+ese+outro	S+DMS+IMS0	I
co#gallo#desoutros	co#gallo#de+eses+outros	S+DMP+IMP0	I
co#gallo#desta	co#gallo#de+esta	S+DFS	I
co#gallo#destas	co#gallo#de+estas	S+DFP	I
co#gallo#deste	co#gallo#de+este	S+DMS	I
co#gallo#destes	co#gallo#de+estes	S+DMP	I
co#gallo#destoutra	co#gallo#de+esta+outra	S+DFS+IFS0	I
co#gallo#destoutras	co#gallo#de+estas+outras	S+DFP+IFP0	I
co#gallo#destoutro	co#gallo#de+este+outro	S+DMS+IMS0	I
co#gallo#destoutros	co#gallo#de+estes+outros	S+DMP+IMP0	I
co#gallo#diso	co#gallo#de+iso	S+DNS	I
co#gallo#disto	co#gallo#de+isto	S+DNS	I
co#gallo#do	co#gallo#de+o	S+GMS	I
co#gallo#dos	co#gallo#de+os	S+GMP	I
co#gallo#doutra	co#gallo#de+outra	S+IFS0	I
co#gallo#doutras	co#gallo#de+outras	S+IFP0	I
co#gallo#doutro	co#gallo#de+outro	S+IMS0	I
co#gallo#doutros	co#gallo#de+outros	S+IMP0	I
co#gallo#dun	co#gallo#de+un	S+IMS0	I
co#gallo#dunha	co#gallo#de+unha	S+IFS0	I
co#gallo#dunhas	co#gallo#de+unhas	S+IFP0	I
co#gallo#duns	co#gallo#de+uns	S+IMP0	I
comparado#á	comparado#a+a	S+GFS	I
comparado#ás	comparado#a+as	S+GFP	I
comparado#ó	comparado#a+o	S+GMS	I
comparado#a	comparado#a	S	I
comparado#ao	comparado#a+o	S+GMS	I
comparado#aos	comparado#a+os	S+GMP	I
comparado#co	comparado#con+o	S+GMS	I
comparado#coa	comparado#con+a	S+GFS	I
comparado#coas	comparado#con+as	S+GFP	I
comparado#con	comparado#con	S	I
comparado#cos	comparado#con+os	S+GMP	I
comparado#cun	comparado#con+un	S+IMS0	I
comparado#cunha	comparado#con+unha	S+IFS0	I
comparado#cunhas	comparado#con+unhas+IFP0	S	I
comparado#cuns	comparado#con+uns	S+IMP0	I
comparante#á	comparante#a+a	S+GFS	I
comparante#ás	comparante#a+as	S+GFP	I
comparante#ó	comparante#a+o	S+GMS	I
comparante#a	comparante#a	S	I
comparante#ao	comparante#a+o	S+GMS	I
comparante#aos	comparante#a+os	S+GMP	I
comparante#co	comparante#con+o	S+GMS	I
comparante#coa	comparante#con+a	S+GFS	I
comparante#coas	comparante#con+as	S+GFP	I
comparante#con	comparante#con	S	I
comparante#cos	comparante#con+os	S+GMP	I
comparante#cun	comparante#con+un	S+IMS0	I
comparante#cunha	comparante#con+unha	S+IFS0	I
comparante#cunhas	comparante#con+unhas+IFP0	S	I
comparante#cuns	comparante#con+uns	S+IMP0	I
con#respecto#á	con#respecto#a+a	S+GFS	I
con#respecto#ás	con#respecto#a+as	S+GFP	I
con#respecto#ó	con#respecto#a+o	S+GMS	I
con#respecto#a	con#respecto#a	S	I
con#respecto#ao	con#respecto#a+o	S+GMS	I
con#respecto#aos	con#respecto#a+os	S+GMP	I
contra#da	contra#de+a	S+GFS	I
contra#dalgún	contra#de+algún	S+IMS0	I
contra#dalgúns	contra#de+algúns	S+IMP0	I
contra#dalgunha	contra#de+algunha	S+IFS0	I
contra#dalgunhas	contra#de+algunhas	S+IFP0	I
contra#daquel	contra#de+aquel	S+DMS	I
contra#daquela	contra#de+aquela	S+DFS	I
contra#daquelas	contra#de+aquelas	S+DFP	I
contra#daqueles	contra#de+aqueles	S+DMP	I
contra#daqueloutra	contra#de+aquela+outra	S+DFS+IFS0	I
contra#daqueloutras	contra#de+aquelas+outras	S+DFP+IFP0	I
contra#daqueloutro	contra#de+aquel+outro	S+DMS+IMS0	I
contra#daqueloutros	contra#de+aqueles+outros	S+DMP+IMP0	I
contra#daquilo	contra#de+aquilo	S+DNS	I
contra#das	contra#de+as	S+GFP	I
contra#de	contra#de	S	I
contra#del	contra#de+el	S+P3MSB0	I
contra#dela	contra#de+ela	S+P3FSB0	I
contra#delas	contra#de+elas	S+P3FPB0	I
contra#deles	contra#de+eles	S+P3MPB0	I
contra#desa	contra#de+esa	S+DFS	I
contra#desas	contra#de+esas	S+DFP	I
contra#dese	contra#de+ese	S+DMS	I
contra#deses	contra#de+eses	S+DMP	I
contra#desoutra	contra#de+esa+outra	S+DFS+IFS0	I
contra#desoutras	contra#de+esas+outras	S+DFP+IFP0	I
contra#desoutro	contra#de+ese+outro	S+DMS+IMS0	I
contra#desoutros	contra#de+eses+outros	S+DMP+IMP0	I
contra#desta	contra#de+esta	S+DFS	I
contra#destas	contra#de+estas	S+DFP	I
contra#deste	contra#de+este	S+DMS	I
contra#destes	contra#de+estes	S+DMP	I
contra#destoutra	contra#de+esta+outra	S+DFS+IFS0	I
contra#destoutras	contra#de+estas+outras	S+DFP+IFP0	I
contra#destoutro	contra#de+este+outro	S+DMS+IMS0	I
contra#destoutros	contra#de+estes+outros	S+DMP+IMP0	I
contra#diso	contra#de+iso	S+DNS	I
contra#disto	contra#de+isto	S+DNS	I
contra#do	contra#de+o	S+GMS	I
contra#dos	contra#de+os	S+GMP	I
contra#doutra	contra#de+outra	S+IFS0	I
contra#doutras	contra#de+outras	S+IFP0	I
contra#doutro	contra#de+outro	S+IMS0	I
contra#doutros	contra#de+outros	S+IMP0	I
contra#dun	contra#de+un	S+IMS0	I
contra#dunha	contra#de+unha	S+IFS0	I
contra#dunhas	contra#de+unhas	S+IFP0	I
contra#duns	contra#de+uns	S+IMP0	I
de#carón#da	de#carón#de+a	S+GFS	I
de#carón#dalgún	de#carón#de+algún	S+IMS0	I
de#carón#dalgúns	de#carón#de+algúns	S+IMP0	I
de#carón#dalgunha	de#carón#de+algunha	S+IFS0	I
de#carón#dalgunhas	de#carón#de+algunhas	S+IFP0	I
de#carón#daquel	de#carón#de+aquel	S+DMS	I
de#carón#daquela	de#carón#de+aquela	S+DFS	I
de#carón#daquelas	de#carón#de+aquelas	S+DFP	I
de#carón#daqueles	de#carón#de+aqueles	S+DMP	I
de#carón#daqueloutra	de#carón#de+aquela+outra	S+DFS+IFS0	I
de#carón#daqueloutras	de#carón#de+aquelas+outras	S+DFP+IFP0	I
de#carón#daqueloutro	de#carón#de+aquel+outro	S+DMS+IMS0	I
de#carón#daqueloutros	de#carón#de+aqueles+outros	S+DMP+IMP0	I
de#carón#daquilo	de#carón#de+aquilo	S+DNS	I
de#carón#das	de#carón#de+as	S+GFP	I
de#carón#de	de#carón#de	S	I
de#carón#del	de#carón#de+el	S+P3MSB0	I
de#carón#dela	de#carón#de+ela	S+P3FSB0	I
de#carón#delas	de#carón#de+elas	S+P3FPB0	I
de#carón#deles	de#carón#de+eles	S+P3MPB0	I
de#carón#desa	de#carón#de+esa	S+DFS	I
de#carón#desas	de#carón#de+esas	S+DFP	I
de#carón#dese	de#carón#de+ese	S+DMS	I
de#carón#deses	de#carón#de+eses	S+DMP	I
de#carón#desoutra	de#carón#de+esa+outra	S+DFS+IFS0	I
de#carón#desoutras	de#carón#de+esas+outras	S+DFP+IFP0	I
de#carón#desoutro	de#carón#de+ese+outro	S+DMS+IMS0	I
de#carón#desoutros	de#carón#de+eses+outros	S+DMP+IMP0	I
de#carón#desta	de#carón#de+esta	S+DFS	I
de#carón#destas	de#carón#de+estas	S+DFP	I
de#carón#deste	de#carón#de+este	S+DMS	I
de#carón#destes	de#carón#de+estes	S+DMP	I
de#carón#destoutra	de#carón#de+esta+outra	S+DFS+IFS0	I
de#carón#destoutras	de#carón#de+estas+outras	S+DFP+IFP0	I
de#carón#destoutro	de#carón#de+este+outro	S+DMS+IMS0	I
de#carón#destoutros	de#carón#de+estes+outros	S+DMP+IMP0	I
de#carón#diso	de#carón#de+iso	S+DNS	I
de#carón#disto	de#carón#de+isto	S+DNS	I
de#carón#do	de#carón#de+o	S+GMS	I
de#carón#dos	de#carón#de+os	S+GMP	I
de#carón#doutra	de#carón#de+outra	S+IFS0	I
de#carón#doutras	de#carón#de+outras	S+IFP0	I
de#carón#doutro	de#carón#de+outro	S+IMS0	I
de#carón#doutros	de#carón#de+outros	S+IMP0	I
de#carón#dun	de#carón#de+un	S+IMS0	I
de#carón#dunha	de#carón#de+unha	S+IFS0	I
de#carón#dunhas	de#carón#de+unhas	S+IFP0	I
de#carón#duns	de#carón#de+uns	S+IMP0	I
de#par#da	de#par#de+a	S+GFS	I
de#par#dalgún	de#par#de+algún	S+IMS0	I
de#par#dalgúns	de#par#de+algúns	S+IMP0	I
de#par#dalgunha	de#par#de+algunha	S+IFS0	I
de#par#dalgunhas	de#par#de+algunhas	S+IFP0	I
de#par#daquel	de#par#de+aquel	S+DMS	I
de#par#daquela	de#par#de+aquela	S+DFS	I
de#par#daquelas	de#par#de+aquelas	S+DFP	I
de#par#daqueles	de#par#de+aqueles	S+DMP	I
de#par#daqueloutra	de#par#de+aquela+outra	S+DFS+IFS0	I
de#par#daqueloutras	de#par#de+aquelas+outras	S+DFP+IFP0	I
de#par#daqueloutro	de#par#de+aquel+outro	S+DMS+IMS0	I
de#par#daqueloutros	de#par#de+aqueles+outros	S+DMP+IMP0	I
de#par#daquilo	de#par#de+aquilo	S+DNS	I
de#par#das	de#par#de+as	S+GFP	I
de#par#de	de#par#de	S	I
de#par#del	de#par#de+el	S+P3MSB0	I
de#par#dela	de#par#de+ela	S+P3FSB0	I
de#par#delas	de#par#de+elas	S+P3FPB0	I
de#par#deles	de#par#de+eles	S+P3MPB0	I
de#par#desa	de#par#de+esa	S+DFS	I
de#par#desas	de#par#de+esas	S+DFP	I
de#par#dese	de#par#de+ese	S+DMS	I
de#par#deses	de#par#de+eses	S+DMP	I
de#par#desoutra	de#par#de+esa+outra	S+DFS+IFS0	I
de#par#desoutras	de#par#de+esas+outras	S+DFP+IFP0	I
de#par#desoutro	de#par#de+ese+outro	S+DMS+IMS0	I
de#par#desoutros	de#par#de+eses+outros	S+DMP+IMP0	I
de#par#desta	de#par#de+esta	S+DFS	I
de#par#destas	de#par#de+estas	S+DFP	I
de#par#deste	de#par#de+este	S+DMS	I
de#par#destes	de#par#de+estes	S+DMP	I
de#par#destoutra	de#par#de+esta+outra	S+DFS+IFS0	I
de#par#destoutras	de#par#de+estas+outras	S+DFP+IFP0	I
de#par#destoutro	de#par#de+este+outro	S+DMS+IMS0	I
de#par#destoutros	de#par#de+estes+outros	S+DMP+IMP0	I
de#par#diso	de#par#de+iso	S+DNS	I
de#par#disto	de#par#de+isto	S+DNS	I
de#par#do	de#par#de+o	S+GMS	I
de#par#dos	de#par#de+os	S+GMP	I
de#par#doutra	de#par#de+outra	S+IFS0	I
de#par#doutras	de#par#de+outras	S+IFP0	I
de#par#doutro	de#par#de+outro	S+IMS0	I
de#par#doutros	de#par#de+outros	S+IMP0	I
de#par#dun	de#par#de+un	S+IMS0	I
de#par#dunha	de#par#de+unha	S+IFS0	I
de#par#dunhas	de#par#de+unhas	S+IFP0	I
de#par#duns	de#par#de+uns	S+IMP0	I
de#través#da	de#través#de+a	S+GFS	I
de#través#dalgún	de#través#de+algún	S+IMS0	I
de#través#dalgúns	de#través#de+algúns	S+IMP0	I
de#través#dalgunha	de#través#de+algunha	S+IFS0	I
de#través#dalgunhas	de#través#de+algunhas	S+IFP0	I
de#través#daquel	de#través#de+aquel	S+DMS	I
de#través#daquela	de#través#de+aquela	S+DFS	I
de#través#daquelas	de#través#de+aquelas	S+DFP	I
de#través#daqueles	de#través#de+aqueles	S+DMP	I
de#través#daqueloutra	de#través#de+aquela+outra	S+DFS+IFS0	I
de#través#daqueloutras	de#través#de+aquelas+outras	S+DFP+IFP0	I
de#través#daqueloutro	de#través#de+aquel+outro	S+DMS+IMS0	I
de#través#daqueloutros	de#través#de+aqueles+outros	S+DMP+IMP0	I
de#través#daquilo	de#través#de+aquilo	S+DNS	I
de#través#das	de#través#de+as	S+GFP	I
de#través#de	de#través#de	S	I
de#través#del	de#través#de+el	S+P3MSB0	I
de#través#dela	de#través#de+ela	S+P3FSB0	I
de#través#delas	de#través#de+elas	S+P3FPB0	I
de#través#deles	de#través#de+eles	S+P3MPB0	I
de#través#desa	de#través#de+esa	S+DFS	I
de#través#desas	de#través#de+esas	S+DFP	I
de#través#dese	de#través#de+ese	S+DMS	I
de#través#deses	de#través#de+eses	S+DMP	I
de#través#desoutra	de#través#de+esa+outra	S+DFS+IFS0	I
de#través#desoutras	de#través#de+esas+outras	S+DFP+IFP0	I
de#través#desoutro	de#través#de+ese+outro	S+DMS+IMS0	I
de#través#desoutros	de#través#de+eses+outros	S+DMP+IMP0	I
de#través#desta	de#través#de+esta	S+DFS	I
de#través#destas	de#través#de+estas	S+DFP	I
de#través#deste	de#través#de+este	S+DMS	I
de#través#destes	de#través#de+estes	S+DMP	I
de#través#destoutra	de#través#de+esta+outra	S+DFS+IFS0	I
de#través#destoutras	de#través#de+estas+outras	S+DFP+IFP0	I
de#través#destoutro	de#través#de+este+outro	S+DMS+IMS0	I
de#través#destoutros	de#través#de+estes+outros	S+DMP+IMP0	I
de#través#diso	de#través#de+iso	S+DNS	I
de#través#disto	de#través#de+isto	S+DNS	I
de#través#do	de#través#de+o	S+GMS	I
de#través#dos	de#través#de+os	S+GMP	I
de#través#doutra	de#través#de+outra	S+IFS0	I
de#través#doutras	de#través#de+outras	S+IFP0	I
de#través#doutro	de#través#de+outro	S+IMS0	I
de#través#doutros	de#través#de+outros	S+IMP0	I
de#través#dun	de#través#de+un	S+IMS0	I
de#través#dunha	de#través#de+unha	S+IFS0	I
de#través#dunhas	de#través#de+unhas	S+IFP0	I
de#través#duns	de#través#de+uns	S+IMP0	I
debaixo#da	debaixo#de+a	S+GFS	I
debaixo#dalgún	debaixo#de+algún	S+IMS0	I
debaixo#dalgúns	debaixo#de+algúns	S+IMP0	I
debaixo#dalgunha	debaixo#de+algunha	S+IFS0	I
debaixo#dalgunhas	debaixo#de+algunhas	S+IFP0	I
debaixo#daquel	debaixo#de+aquel	S+DMS	I
debaixo#daquela	debaixo#de+aquela	S+DFS	I
debaixo#daquelas	debaixo#de+aquelas	S+DFP	I
debaixo#daqueles	debaixo#de+aqueles	S+DMP	I
debaixo#daqueloutra	debaixo#de+aquela+outra	S+DFS+IFS0	I
debaixo#daqueloutras	debaixo#de+aquelas+outras	S+DFP+IFP0	I
debaixo#daqueloutro	debaixo#de+aquel+outro	S+DMS+IMS0	I
debaixo#daqueloutros	debaixo#de+aqueles+outros	S+DMP+IMP0	I
debaixo#daquilo	debaixo#de+aquilo	S+DNS	I
debaixo#das	debaixo#de+as	S+GFP	I
debaixo#de	debaixo#de	S	I
debaixo#del	debaixo#de+el	S+P3MSB0	I
debaixo#dela	debaixo#de+ela	S+P3FSB0	I
debaixo#delas	debaixo#de+elas	S+P3FPB0	I
debaixo#deles	debaixo#de+eles	S+P3MPB0	I
debaixo#desa	debaixo#de+esa	S+DFS	I
debaixo#desas	debaixo#de+esas	S+DFP	I
debaixo#dese	debaixo#de+ese	S+DMS	I
debaixo#deses	debaixo#de+eses	S+DMP	I
debaixo#desoutra	debaixo#de+esa+outra	S+DFS+IFS0	I
debaixo#desoutras	debaixo#de+esas+outras	S+DFP+IFP0	I
debaixo#desoutro	debaixo#de+ese+outro	S+DMS+IMS0	I
debaixo#desoutros	debaixo#de+eses+outros	S+DMP+IMP0	I
debaixo#desta	debaixo#de+esta	S+DFS	I
debaixo#destas	debaixo#de+estas	S+DFP	I
debaixo#deste	debaixo#de+este	S+DMS	I
debaixo#destes	debaixo#de+estes	S+DMP	I
debaixo#destoutra	debaixo#de+esta+outra	S+DFS+IFS0	I
debaixo#destoutras	debaixo#de+estas+outras	S+DFP+IFP0	I
debaixo#destoutro	debaixo#de+este+outro	S+DMS+IMS0	I
debaixo#destoutros	debaixo#de+estes+outros	S+DMP+IMP0	I
debaixo#diso	debaixo#de+iso	S+DNS	I
debaixo#disto	debaixo#de+isto	S+DNS	I
debaixo#do	debaixo#de+o	S+GMS	I
debaixo#dos	debaixo#de+os	S+GMP	I
debaixo#doutra	debaixo#de+outra	S+IFS0	I
debaixo#doutras	debaixo#de+outras	S+IFP0	I
debaixo#doutro	debaixo#de+outro	S+IMS0	I
debaixo#doutros	debaixo#de+outros	S+IMP0	I
debaixo#dun	debaixo#de+un	S+IMS0	I
debaixo#dunha	debaixo#de+unha	S+IFS0	I
debaixo#dunhas	debaixo#de+unhas	S+IFP0	I
debaixo#duns	debaixo#de+uns	S+IMP0	I
dentro#da	dentro#de+a	S+GFS	I
dentro#dalgún	dentro#de+algún	S+IMS0	I
dentro#dalgúns	dentro#de+algúns	S+IMP0	I
dentro#dalgunha	dentro#de+algunha	S+IFS0	I
dentro#dalgunhas	dentro#de+algunhas	S+IFP0	I
dentro#daquel	dentro#de+aquel	S+DMS	I
dentro#daquela	dentro#de+aquela	S+DFS	I
dentro#daquelas	dentro#de+aquelas	S+DFP	I
dentro#daqueles	dentro#de+aqueles	S+DMP	I
dentro#daqueloutra	dentro#de+aquela+outra	S+DFS+IFS0	I
dentro#daqueloutras	dentro#de+aquelas+outras	S+DFP+IFP0	I
dentro#daqueloutro	dentro#de+aquel+outro	S+DMS+IMS0	I
dentro#daqueloutros	dentro#de+aqueles+outros	S+DMP+IMP0	I
dentro#daquilo	dentro#de+aquilo	S+DNS	I
dentro#das	dentro#de+as	S+GFP	I
dentro#de	dentro#de	S	I
dentro#del	dentro#de+el	S+P3MSB0	I
dentro#dela	dentro#de+ela	S+P3FSB0	I
dentro#delas	dentro#de+elas	S+P3FPB0	I
dentro#deles	dentro#de+eles	S+P3MPB0	I
dentro#desa	dentro#de+esa	S+DFS	I
dentro#desas	dentro#de+esas	S+DFP	I
dentro#dese	dentro#de+ese	S+DMS	I
dentro#deses	dentro#de+eses	S+DMP	I
dentro#desoutra	dentro#de+esa+outra	S+DFS+IFS0	I
dentro#desoutras	dentro#de+esas+outras	S+DFP+IFP0	I
dentro#desoutro	dentro#de+ese+outro	S+DMS+IMS0	I
dentro#desoutros	dentro#de+eses+outros	S+DMP+IMP0	I
dentro#desta	dentro#de+esta	S+DFS	I
dentro#destas	dentro#de+estas	S+DFP	I
dentro#deste	dentro#de+este	S+DMS	I
dentro#destes	dentro#de+estes	S+DMP	I
dentro#destoutra	dentro#de+esta+outra	S+DFS+IFS0	I
dentro#destoutras	dentro#de+estas+outras	S+DFP+IFP0	I
dentro#destoutro	dentro#de+este+outro	S+DMS+IMS0	I
dentro#destoutros	dentro#de+estes+outros	S+DMP+IMP0	I
dentro#diso	dentro#de+iso	S+DNS	I
dentro#disto	dentro#de+isto	S+DNS	I
dentro#do	dentro#de+o	S+GMS	I
dentro#dos	dentro#de+os	S+GMP	I
dentro#doutra	dentro#de+outra	S+IFS0	I
dentro#doutras	dentro#de+outras	S+IFP0	I
dentro#doutro	dentro#de+outro	S+IMS0	I
dentro#doutros	dentro#de+outros	S+IMP0	I
dentro#dun	dentro#de+un	S+IMS0	I
dentro#dunha	dentro#de+unha	S+IFS0	I
dentro#dunhas	dentro#de+unhas	S+IFP0	I
dentro#duns	dentro#de+uns	S+IMP0	I
derredor#da	derredor#de+a	S+GFS	I
derredor#dalgún	derredor#de+algún	S+IMS0	I
derredor#dalgúns	derredor#de+algúns	S+IMP0	I
derredor#dalgunha	derredor#de+algunha	S+IFS0	I
derredor#dalgunhas	derredor#de+algunhas	S+IFP0	I
derredor#daquel	derredor#de+aquel	S+DMS	I
derredor#daquela	derredor#de+aquela	S+DFS	I
derredor#daquelas	derredor#de+aquelas	S+DFP	I
derredor#daqueles	derredor#de+aqueles	S+DMP	I
derredor#daqueloutra	derredor#de+aquela+outra	S+DFS+IFS0	I
derredor#daqueloutras	derredor#de+aquelas+outras	S+DFP+IFP0	I
derredor#daqueloutro	derredor#de+aquel+outro	S+DMS+IMS0	I
derredor#daqueloutros	derredor#de+aqueles+outros	S+DMP+IMP0	I
derredor#daquilo	derredor#de+aquilo	S+DNS	I
derredor#das	derredor#de+as	S+GFP	I
derredor#de	derredor#de	S	I
derredor#del	derredor#de+el	S+P3MSB0	I
derredor#dela	derredor#de+ela	S+P3FSB0	I
derredor#delas	derredor#de+elas	S+P3FPB0	I
derredor#deles	derredor#de+eles	S+P3MPB0	I
derredor#desa	derredor#de+esa	S+DFS	I
derredor#desas	derredor#de+esas	S+DFP	I
derredor#dese	derredor#de+ese	S+DMS	I
derredor#deses	derredor#de+eses	S+DMP	I
derredor#desoutra	derredor#de+esa+outra	S+DFS+IFS0	I
derredor#desoutras	derredor#de+esas+outras	S+DFP+IFP0	I
derredor#desoutro	derredor#de+ese+outro	S+DMS+IMS0	I
derredor#desoutros	derredor#de+eses+outros	S+DMP+IMP0	I
derredor#desta	derredor#de+esta	S+DFS	I
derredor#destas	derredor#de+estas	S+DFP	I
derredor#deste	derredor#de+este	S+DMS	I
derredor#destes	derredor#de+estes	S+DMP	I
derredor#destoutra	derredor#de+esta+outra	S+DFS+IFS0	I
derredor#destoutras	derredor#de+estas+outras	S+DFP+IFP0	I
derredor#destoutro	derredor#de+este+outro	S+DMS+IMS0	I
derredor#destoutros	derredor#de+estes+outros	S+DMP+IMP0	I
derredor#diso	derredor#de+iso	S+DNS	I
derredor#disto	derredor#de+isto	S+DNS	I
derredor#do	derredor#de+o	S+GMS	I
derredor#dos	derredor#de+os	S+GMP	I
derredor#doutra	derredor#de+outra	S+IFS0	I
derredor#doutras	derredor#de+outras	S+IFP0	I
derredor#doutro	derredor#de+outro	S+IMS0	I
derredor#doutros	derredor#de+outros	S+IMP0	I
derredor#dun	derredor#de+un	S+IMS0	I
derredor#dunha	derredor#de+unha	S+IFS0	I
derredor#dunhas	derredor#de+unhas	S+IFP0	I
derredor#duns	derredor#de+uns	S+IMP0	I
derriba#da	derriba#de+a	S+GFS	I
derriba#dalgún	derriba#de+algún	S+IMS0	I
derriba#dalgúns	derriba#de+algúns	S+IMP0	I
derriba#dalgunha	derriba#de+algunha	S+IFS0	I
derriba#dalgunhas	derriba#de+algunhas	S+IFP0	I
derriba#daquel	derriba#de+aquel	S+DMS	I
derriba#daquela	derriba#de+aquela	S+DFS	I
derriba#daquelas	derriba#de+aquelas	S+DFP	I
derriba#daqueles	derriba#de+aqueles	S+DMP	I
derriba#daqueloutra	derriba#de+aquela+outra	S+DFS+IFS0	I
derriba#daqueloutras	derriba#de+aquelas+outras	S+DFP+IFP0	I
derriba#daqueloutro	derriba#de+aquel+outro	S+DMS+IMS0	I
derriba#daqueloutros	derriba#de+aqueles+outros	S+DMP+IMP0	I
derriba#daquilo	derriba#de+aquilo	S+DNS	I
derriba#das	derriba#de+as	S+GFP	I
derriba#de	derriba#de	S	I
derriba#del	derriba#de+el	S+P3MSB0	I
derriba#dela	derriba#de+ela	S+P3FSB0	I
derriba#delas	derriba#de+elas	S+P3FPB0	I
derriba#deles	derriba#de+eles	S+P3MPB0	I
derriba#desa	derriba#de+esa	S+DFS	I
derriba#desas	derriba#de+esas	S+DFP	I
derriba#dese	derriba#de+ese	S+DMS	I
derriba#deses	derriba#de+eses	S+DMP	I
derriba#desoutra	derriba#de+esa+outra	S+DFS+IFS0	I
derriba#desoutras	derriba#de+esas+outras	S+DFP+IFP0	I
derriba#desoutro	derriba#de+ese+outro	S+DMS+IMS0	I
derriba#desoutros	derriba#de+eses+outros	S+DMP+IMP0	I
derriba#desta	derriba#de+esta	S+DFS	I
derriba#destas	derriba#de+estas	S+DFP	I
derriba#deste	derriba#de+este	S+DMS	I
derriba#destes	derriba#de+estes	S+DMP	I
derriba#destoutra	derriba#de+esta+outra	S+DFS+IFS0	I
derriba#destoutras	derriba#de+estas+outras	S+DFP+IFP0	I
derriba#destoutro	derriba#de+este+outro	S+DMS+IMS0	I
derriba#destoutros	derriba#de+estes+outros	S+DMP+IMP0	I
derriba#diso	derriba#de+iso	S+DNS	I
derriba#disto	derriba#de+isto	S+DNS	I
derriba#do	derriba#de+o	S+GMS	I
derriba#dos	derriba#de+os	S+GMP	I
derriba#doutra	derriba#de+outra	S+IFS0	I
derriba#doutras	derriba#de+outras	S+IFP0	I
derriba#doutro	derriba#de+outro	S+IMS0	I
derriba#doutros	derriba#de+outros	S+IMP0	I
derriba#dun	derriba#de+un	S+IMS0	I
derriba#dunha	derriba#de+unha	S+IFS0	I
derriba#dunhas	derriba#de+unhas	S+IFP0	I
derriba#duns	derriba#de+uns	S+IMP0	I
despois#da	despois#de+a	S+GFS	I
despois#dalgún	despois#de+algún	S+IMS0	I
despois#dalgúns	despois#de+algúns	S+IMP0	I
despois#dalgunha	despois#de+algunha	S+IFS0	I
despois#dalgunhas	despois#de+algunhas	S+IFP0	I
despois#daquel	despois#de+aquel	S+DMS	I
despois#daquela	despois#de+aquela	S+DFS	I
despois#daquelas	despois#de+aquelas	S+DFP	I
despois#daqueles	despois#de+aqueles	S+DMP	I
despois#daqueloutra	despois#de+aquela+outra	S+DFS+IFS0	I
despois#daqueloutras	despois#de+aquelas+outras	S+DFP+IFP0	I
despois#daqueloutro	despois#de+aquel+outro	S+DMS+IMS0	I
despois#daqueloutros	despois#de+aqueles+outros	S+DMP+IMP0	I
despois#daquilo	despois#de+aquilo	S+DNS	I
despois#das	despois#de+as	S+GFP	I
despois#de	despois#de	S	I
despois#del	despois#de+el	S+P3MSB0	I
despois#dela	despois#de+ela	S+P3FSB0	I
despois#delas	despois#de+elas	S+P3FPB0	I
despois#deles	despois#de+eles	S+P3MPB0	I
despois#desa	despois#de+esa	S+DFS	I
despois#desas	despois#de+esas	S+DFP	I
despois#dese	despois#de+ese	S+DMS	I
despois#deses	despois#de+eses	S+DMP	I
despois#desoutra	despois#de+esa+outra	S+DFS+IFS0	I
despois#desoutras	despois#de+esas+outras	S+DFP+IFP0	I
despois#desoutro	despois#de+ese+outro	S+DMS+IMS0	I
despois#desoutros	despois#de+eses+outros	S+DMP+IMP0	I
despois#desta	despois#de+esta	S+DFS	I
despois#destas	despois#de+estas	S+DFP	I
despois#deste	despois#de+este	S+DMS	I
despois#destes	despois#de+estes	S+DMP	I
despois#destoutra	despois#de+esta+outra	S+DFS+IFS0	I
despois#destoutras	despois#de+estas+outras	S+DFP+IFP0	I
despois#destoutro	despois#de+este+outro	S+DMS+IMS0	I
despois#destoutros	despois#de+estes+outros	S+DMP+IMP0	I
despois#diso	despois#de+iso	S+DNS	I
despois#disto	despois#de+isto	S+DNS	I
despois#do	despois#de+o	S+GMS	I
despois#dos	despois#de+os	S+GMP	I
despois#doutra	despois#de+outra	S+IFS0	I
despois#doutras	despois#de+outras	S+IFP0	I
despois#doutro	despois#de+outro	S+IMS0	I
despois#doutros	despois#de+outros	S+IMP0	I
despois#dun	despois#de+un	S+IMS0	I
despois#dunha	despois#de+unha	S+IFS0	I
despois#dunhas	despois#de+unhas	S+IFP0	I
despois#duns	despois#de+uns	S+IMP0	I
detrás#da	detrás#de+a	S+GFS	I
detrás#dalgún	detrás#de+algún	S+IMS0	I
detrás#dalgúns	detrás#de+algúns	S+IMP0	I
detrás#dalgunha	detrás#de+algunha	S+IFS0	I
detrás#dalgunhas	detrás#de+algunhas	S+IFP0	I
detrás#daquel	detrás#de+aquel	S+DMS	I
detrás#daquela	detrás#de+aquela	S+DFS	I
detrás#daquelas	detrás#de+aquelas	S+DFP	I
detrás#daqueles	detrás#de+aqueles	S+DMP	I
detrás#daqueloutra	detrás#de+aquela+outra	S+DFS+IFS0	I
detrás#daqueloutras	detrás#de+aquelas+outras	S+DFP+IFP0	I
detrás#daqueloutro	detrás#de+aquel+outro	S+DMS+IMS0	I
detrás#daqueloutros	detrás#de+aqueles+outros	S+DMP+IMP0	I
detrás#daquilo	detrás#de+aquilo	S+DNS	I
detrás#das	detrás#de+as	S+GFP	I
detrás#de	detrás#de	S	I
detrás#del	detrás#de+el	S+P3MSB0	I
detrás#dela	detrás#de+ela	S+P3FSB0	I
detrás#delas	detrás#de+elas	S+P3FPB0	I
detrás#deles	detrás#de+eles	S+P3MPB0	I
detrás#desa	detrás#de+esa	S+DFS	I
detrás#desas	detrás#de+esas	S+DFP	I
detrás#dese	detrás#de+ese	S+DMS	I
detrás#deses	detrás#de+eses	S+DMP	I
detrás#desoutra	detrás#de+esa+outra	S+DFS+IFS0	I
detrás#desoutras	detrás#de+esas+outras	S+DFP+IFP0	I
detrás#desoutro	detrás#de+ese+outro	S+DMS+IMS0	I
detrás#desoutros	detrás#de+eses+outros	S+DMP+IMP0	I
detrás#desta	detrás#de+esta	S+DFS	I
detrás#destas	detrás#de+estas	S+DFP	I
detrás#deste	detrás#de+este	S+DMS	I
detrás#destes	detrás#de+estes	S+DMP	I
detrás#destoutra	detrás#de+esta+outra	S+DFS+IFS0	I
detrás#destoutras	detrás#de+estas+outras	S+DFP+IFP0	I
detrás#destoutro	detrás#de+este+outro	S+DMS+IMS0	I
detrás#destoutros	detrás#de+estes+outros	S+DMP+IMP0	I
detrás#diso	detrás#de+iso	S+DNS	I
detrás#disto	detrás#de+isto	S+DNS	I
detrás#do	detrás#de+o	S+GMS	I
detrás#dos	detrás#de+os	S+GMP	I
detrás#doutra	detrás#de+outra	S+IFS0	I
detrás#doutras	detrás#de+outras	S+IFP0	I
detrás#doutro	detrás#de+outro	S+IMS0	I
detrás#doutros	detrás#de+outros	S+IMP0	I
detrás#dun	detrás#de+un	S+IMS0	I
detrás#dunha	detrás#de+unha	S+IFS0	I
detrás#dunhas	detrás#de+unhas	S+IFP0	I
detrás#duns	detrás#de+uns	S+IMP0	I
diante#da	diante#de+a	S+GFS	I
diante#dalgún	diante#de+algún	S+IMS0	I
diante#dalgúns	diante#de+algúns	S+IMP0	I
diante#dalgunha	diante#de+algunha	S+IFS0	I
diante#dalgunhas	diante#de+algunhas	S+IFP0	I
diante#daquel	diante#de+aquel	S+DMS	I
diante#daquela	diante#de+aquela	S+DFS	I
diante#daquelas	diante#de+aquelas	S+DFP	I
diante#daqueles	diante#de+aqueles	S+DMP	I
diante#daqueloutra	diante#de+aquela+outra	S+DFS+IFS0	I
diante#daqueloutras	diante#de+aquelas+outras	S+DFP+IFP0	I
diante#daqueloutro	diante#de+aquel+outro	S+DMS+IMS0	I
diante#daqueloutros	diante#de+aqueles+outros	S+DMP+IMP0	I
diante#daquilo	diante#de+aquilo	S+DNS	I
diante#das	diante#de+as	S+GFP	I
diante#de	diante#de	S	I
diante#del	diante#de+el	S+P3MSB0	I
diante#dela	diante#de+ela	S+P3FSB0	I
diante#delas	diante#de+elas	S+P3FPB0	I
diante#deles	diante#de+eles	S+P3MPB0	I
diante#desa	diante#de+esa	S+DFS	I
diante#desas	diante#de+esas	S+DFP	I
diante#dese	diante#de+ese	S+DMS	I
diante#deses	diante#de+eses	S+DMP	I
diante#desoutra	diante#de+esa+outra	S+DFS+IFS0	I
diante#desoutras	diante#de+esas+outras	S+DFP+IFP0	I
diante#desoutro	diante#de+ese+outro	S+DMS+IMS0	I
diante#desoutros	diante#de+eses+outros	S+DMP+IMP0	I
diante#desta	diante#de+esta	S+DFS	I
diante#destas	diante#de+estas	S+DFP	I
diante#deste	diante#de+este	S+DMS	I
diante#destes	diante#de+estes	S+DMP	I
diante#destoutra	diante#de+esta+outra	S+DFS+IFS0	I
diante#destoutras	diante#de+estas+outras	S+DFP+IFP0	I
diante#destoutro	diante#de+este+outro	S+DMS+IMS0	I
diante#destoutros	diante#de+estes+outros	S+DMP+IMP0	I
diante#diso	diante#de+iso	S+DNS	I
diante#disto	diante#de+isto	S+DNS	I
diante#do	diante#de+o	S+GMS	I
diante#dos	diante#de+os	S+GMP	I
diante#doutra	diante#de+outra	S+IFS0	I
diante#doutras	diante#de+outras	S+IFP0	I
diante#doutro	diante#de+outro	S+IMS0	I
diante#doutros	diante#de+outros	S+IMP0	I
diante#dun	diante#de+un	S+IMS0	I
diante#dunha	diante#de+unha	S+IFS0	I
diante#dunhas	diante#de+unhas	S+IFP0	I
diante#duns	diante#de+uns	S+IMP0	I
en#canto#á	en#canto#a+a	S+GFS	I
en#canto#ás	en#canto#a+as	S+GFP	I
en#canto#ó	en#canto#a+o	S+GMS	I
en#canto#a	en#canto#a	S	I
en#canto#ao	en#canto#a+o	S+GMS	I
en#canto#aos	en#canto#a+os	S+GMP	I
en#diante#da	en#diante#de+a	S+GFS	I
en#diante#dalgún	en#diante#de+algún	S+IMS0	I
en#diante#dalgúns	en#diante#de+algúns	S+IMP0	I
en#diante#dalgunha	en#diante#de+algunha	S+IFS0	I
en#diante#dalgunhas	en#diante#de+algunhas	S+IFP0	I
en#diante#daquel	en#diante#de+aquel	S+DMS	I
en#diante#daquela	en#diante#de+aquela	S+DFS	I
en#diante#daquelas	en#diante#de+aquelas	S+DFP	I
en#diante#daqueles	en#diante#de+aqueles	S+DMP	I
en#diante#daqueloutra	en#diante#de+aquela+outra	S+DFS+IFS0	I
en#diante#daqueloutras	en#diante#de+aquelas+outras	S+DFP+IFP0	I
en#diante#daqueloutro	en#diante#de+aquel+outro	S+DMS+IMS0	I
en#diante#daqueloutros	en#diante#de+aqueles+outros	S+DMP+IMP0	I
en#diante#daquilo	en#diante#de+aquilo	S+DNS	I
en#diante#das	en#diante#de+as	S+GFP	I
en#diante#de	en#diante#de	S	I
en#diante#del	en#diante#de+el	S+P3MSB0	I
en#diante#dela	en#diante#de+ela	S+P3FSB0	I
en#diante#delas	en#diante#de+elas	S+P3FPB0	I
en#diante#deles	en#diante#de+eles	S+P3MPB0	I
en#diante#desa	en#diante#de+esa	S+DFS	I
en#diante#desas	en#diante#de+esas	S+DFP	I
en#diante#dese	en#diante#de+ese	S+DMS	I
en#diante#deses	en#diante#de+eses	S+DMP	I
en#diante#desoutra	en#diante#de+esa+outra	S+DFS+IFS0	I
en#diante#desoutras	en#diante#de+esas+outras	S+DFP+IFP0	I
en#diante#desoutro	en#diante#de+ese+outro	S+DMS+IMS0	I
en#diante#desoutros	en#diante#de+eses+outros	S+DMP+IMP0	I
en#diante#desta	en#diante#de+esta	S+DFS	I
en#diante#destas	en#diante#de+estas	S+DFP	I
en#diante#deste	en#diante#de+este	S+DMS	I
en#diante#destes	en#diante#de+estes	S+DMP	I
en#diante#destoutra	en#diante#de+esta+outra	S+DFS+IFS0	I
en#diante#destoutras	en#diante#de+estas+outras	S+DFP+IFP0	I
en#diante#destoutro	en#diante#de+este+outro	S+DMS+IMS0	I
en#diante#destoutros	en#diante#de+estes+outros	S+DMP+IMP0	I
en#diante#diso	en#diante#de+iso	S+DNS	I
en#diante#disto	en#diante#de+isto	S+DNS	I
en#diante#do	en#diante#de+o	S+GMS	I
en#diante#dos	en#diante#de+os	S+GMP	I
en#diante#doutra	en#diante#de+outra	S+IFS0	I
en#diante#doutras	en#diante#de+outras	S+IFP0	I
en#diante#doutro	en#diante#de+outro	S+IMS0	I
en#diante#doutros	en#diante#de+outros	S+IMP0	I
en#diante#dun	en#diante#de+un	S+IMS0	I
en#diante#dunha	en#diante#de+unha	S+IFS0	I
en#diante#dunhas	en#diante#de+unhas	S+IFP0	I
en#diante#duns	en#diante#de+uns	S+IMP0	I
en#favor#da	en#favor#de+a	S+GFS	I
en#favor#dalgún	en#favor#de+algún	S+IMS0	I
en#favor#dalgúns	en#favor#de+algúns	S+IMP0	I
en#favor#dalgunha	en#favor#de+algunha	S+IFS0	I
en#favor#dalgunhas	en#favor#de+algunhas	S+IFP0	I
en#favor#daquel	en#favor#de+aquel	S+DMS	I
en#favor#daquela	en#favor#de+aquela	S+DFS	I
en#favor#daquelas	en#favor#de+aquelas	S+DFP	I
en#favor#daqueles	en#favor#de+aqueles	S+DMP	I
en#favor#daqueloutra	en#favor#de+aquela+outra	S+DFS+IFS0	I
en#favor#daqueloutras	en#favor#de+aquelas+outras	S+DFP+IFP0	I
en#favor#daqueloutro	en#favor#de+aquel+outro	S+DMS+IMS0	I
en#favor#daqueloutros	en#favor#de+aqueles+outros	S+DMP+IMP0	I
en#favor#daquilo	en#favor#de+aquilo	S+DNS	I
en#favor#das	en#favor#de+as	S+GFP	I
en#favor#de	en#favor#de	S	I
en#favor#del	en#favor#de+el	S+P3MSB0	I
en#favor#dela	en#favor#de+ela	S+P3FSB0	I
en#favor#delas	en#favor#de+elas	S+P3FPB0	I
en#favor#deles	en#favor#de+eles	S+P3MPB0	I
en#favor#desa	en#favor#de+esa	S+DFS	I
en#favor#desas	en#favor#de+esas	S+DFP	I
en#favor#dese	en#favor#de+ese	S+DMS	I
en#favor#deses	en#favor#de+eses	S+DMP	I
en#favor#desoutra	en#favor#de+esa+outra	S+DFS+IFS0	I
en#favor#desoutras	en#favor#de+esas+outras	S+DFP+IFP0	I
en#favor#desoutro	en#favor#de+ese+outro	S+DMS+IMS0	I
en#favor#desoutros	en#favor#de+eses+outros	S+DMP+IMP0	I
en#favor#desta	en#favor#de+esta	S+DFS	I
en#favor#destas	en#favor#de+estas	S+DFP	I
en#favor#deste	en#favor#de+este	S+DMS	I
en#favor#destes	en#favor#de+estes	S+DMP	I
en#favor#destoutra	en#favor#de+esta+outra	S+DFS+IFS0	I
en#favor#destoutras	en#favor#de+estas+outras	S+DFP+IFP0	I
en#favor#destoutro	en#favor#de+este+outro	S+DMS+IMS0	I
en#favor#destoutros	en#favor#de+estes+outros	S+DMP+IMP0	I
en#favor#diso	en#favor#de+iso	S+DNS	I
en#favor#disto	en#favor#de+isto	S+DNS	I
en#favor#do	en#favor#de+o	S+GMS	I
en#favor#dos	en#favor#de+os	S+GMP	I
en#favor#doutra	en#favor#de+outra	S+IFS0	I
en#favor#doutras	en#favor#de+outras	S+IFP0	I
en#favor#doutro	en#favor#de+outro	S+IMS0	I
en#favor#doutros	en#favor#de+outros	S+IMP0	I
en#favor#dun	en#favor#de+un	S+IMS0	I
en#favor#dunha	en#favor#de+unha	S+IFS0	I
en#favor#dunhas	en#favor#de+unhas	S+IFP0	I
en#favor#duns	en#favor#de+uns	S+IMP0	I
en#fronte#da	en#fronte#de+a	S+GFS	I
en#fronte#dalgún	en#fronte#de+algún	S+IMS0	I
en#fronte#dalgúns	en#fronte#de+algúns	S+IMP0	I
en#fronte#dalgunha	en#fronte#de+algunha	S+IFS0	I
en#fronte#dalgunhas	en#fronte#de+algunhas	S+IFP0	I
en#fronte#daquel	en#fronte#de+aquel	S+DMS	I
en#fronte#daquela	en#fronte#de+aquela	S+DFS	I
en#fronte#daquelas	en#fronte#de+aquelas	S+DFP	I
en#fronte#daqueles	en#fronte#de+aqueles	S+DMP	I
en#fronte#daqueloutra	en#fronte#de+aquela+outra	S+DFS+IFS0	I
en#fronte#daqueloutras	en#fronte#de+aquelas+outras	S+DFP+IFP0	I
en#fronte#daqueloutro	en#fronte#de+aquel+outro	S+DMS+IMS0	I
en#fronte#daqueloutros	en#fronte#de+aqueles+outros	S+DMP+IMP0	I
en#fronte#daquilo	en#fronte#de+aquilo	S+DNS	I
en#fronte#das	en#fronte#de+as	S+GFP	I
en#fronte#de	en#fronte#de	S	I
en#fronte#del	en#fronte#de+el	S+P3MSB0	I
en#fronte#dela	en#fronte#de+ela	S+P3FSB0	I
en#fronte#delas	en#fronte#de+elas	S+P3FPB0	I
en#fronte#deles	en#fronte#de+eles	S+P3MPB0	I
en#fronte#desa	en#fronte#de+esa	S+DFS	I
en#fronte#desas	en#fronte#de+esas	S+DFP	I
en#fronte#dese	en#fronte#de+ese	S+DMS	I
en#fronte#deses	en#fronte#de+eses	S+DMP	I
en#fronte#desoutra	en#fronte#de+esa+outra	S+DFS+IFS0	I
en#fronte#desoutras	en#fronte#de+esas+outras	S+DFP+IFP0	I
en#fronte#desoutro	en#fronte#de+ese+outro	S+DMS+IMS0	I
en#fronte#desoutros	en#fronte#de+eses+outros	S+DMP+IMP0	I
en#fronte#desta	en#fronte#de+esta	S+DFS	I
en#fronte#destas	en#fronte#de+estas	S+DFP	I
en#fronte#deste	en#fronte#de+este	S+DMS	I
en#fronte#destes	en#fronte#de+estes	S+DMP	I
en#fronte#destoutra	en#fronte#de+esta+outra	S+DFS+IFS0	I
en#fronte#destoutras	en#fronte#de+estas+outras	S+DFP+IFP0	I
en#fronte#destoutro	en#fronte#de+este+outro	S+DMS+IMS0	I
en#fronte#destoutros	en#fronte#de+estes+outros	S+DMP+IMP0	I
en#fronte#diso	en#fronte#de+iso	S+DNS	I
en#fronte#disto	en#fronte#de+isto	S+DNS	I
en#fronte#do	en#fronte#de+o	S+GMS	I
en#fronte#dos	en#fronte#de+os	S+GMP	I
en#fronte#doutra	en#fronte#de+outra	S+IFS0	I
en#fronte#doutras	en#fronte#de+outras	S+IFP0	I
en#fronte#doutro	en#fronte#de+outro	S+IMS0	I
en#fronte#doutros	en#fronte#de+outros	S+IMP0	I
en#fronte#dun	en#fronte#de+un	S+IMS0	I
en#fronte#dunha	en#fronte#de+unha	S+IFS0	I
en#fronte#dunhas	en#fronte#de+unhas	S+IFP0	I
en#fronte#duns	en#fronte#de+uns	S+IMP0	I
en#lugar#da	en#lugar#de+a	S+GFS	I
en#lugar#dalgún	en#lugar#de+algún	S+IMS0	I
en#lugar#dalgúns	en#lugar#de+algúns	S+IMP0	I
en#lugar#dalgunha	en#lugar#de+algunha	S+IFS0	I
en#lugar#dalgunhas	en#lugar#de+algunhas	S+IFP0	I
en#lugar#daquel	en#lugar#de+aquel	S+DMS	I
en#lugar#daquela	en#lugar#de+aquela	S+DFS	I
en#lugar#daquelas	en#lugar#de+aquelas	S+DFP	I
en#lugar#daqueles	en#lugar#de+aqueles	S+DMP	I
en#lugar#daqueloutra	en#lugar#de+aquela+outra	S+DFS+IFS0	I
en#lugar#daqueloutras	en#lugar#de+aquelas+outras	S+DFP+IFP0	I
en#lugar#daqueloutro	en#lugar#de+aquel+outro	S+DMS+IMS0	I
en#lugar#daqueloutros	en#lugar#de+aqueles+outros	S+DMP+IMP0	I
en#lugar#daquilo	en#lugar#de+aquilo	S+DNS	I
en#lugar#das	en#lugar#de+as	S+GFP	I
en#lugar#de	en#lugar#de	S	I
en#lugar#del	en#lugar#de+el	S+P3MSB0	I
en#lugar#dela	en#lugar#de+ela	S+P3FSB0	I
en#lugar#delas	en#lugar#de+elas	S+P3FPB0	I
en#lugar#deles	en#lugar#de+eles	S+P3MPB0	I
en#lugar#desa	en#lugar#de+esa	S+DFS	I
en#lugar#desas	en#lugar#de+esas	S+DFP	I
en#lugar#dese	en#lugar#de+ese	S+DMS	I
en#lugar#deses	en#lugar#de+eses	S+DMP	I
en#lugar#desoutra	en#lugar#de+esa+outra	S+DFS+IFS0	I
en#lugar#desoutras	en#lugar#de+esas+outras	S+DFP+IFP0	I
en#lugar#desoutro	en#lugar#de+ese+outro	S+DMS+IMS0	I
en#lugar#desoutros	en#lugar#de+eses+outros	S+DMP+IMP0	I
en#lugar#desta	en#lugar#de+esta	S+DFS	I
en#lugar#destas	en#lugar#de+estas	S+DFP	I
en#lugar#deste	en#lugar#de+este	S+DMS	I
en#lugar#destes	en#lugar#de+estes	S+DMP	I
en#lugar#destoutra	en#lugar#de+esta+outra	S+DFS+IFS0	I
en#lugar#destoutras	en#lugar#de+estas+outras	S+DFP+IFP0	I
en#lugar#destoutro	en#lugar#de+este+outro	S+DMS+IMS0	I
en#lugar#destoutros	en#lugar#de+estes+outros	S+DMP+IMP0	I
en#lugar#diso	en#lugar#de+iso	S+DNS	I
en#lugar#disto	en#lugar#de+isto	S+DNS	I
en#lugar#do	en#lugar#de+o	S+GMS	I
en#lugar#dos	en#lugar#de+os	S+GMP	I
en#lugar#doutra	en#lugar#de+outra	S+IFS0	I
en#lugar#doutras	en#lugar#de+outras	S+IFP0	I
en#lugar#doutro	en#lugar#de+outro	S+IMS0	I
en#lugar#doutros	en#lugar#de+outros	S+IMP0	I
en#lugar#dun	en#lugar#de+un	S+IMS0	I
en#lugar#dunha	en#lugar#de+unha	S+IFS0	I
en#lugar#dunhas	en#lugar#de+unhas	S+IFP0	I
en#lugar#duns	en#lugar#de+uns	S+IMP0	I
en#par#da	en#par#de+a	S+GFS	I
en#par#dalgún	en#par#de+algún	S+IMS0	I
en#par#dalgúns	en#par#de+algúns	S+IMP0	I
en#par#dalgunha	en#par#de+algunha	S+IFS0	I
en#par#dalgunhas	en#par#de+algunhas	S+IFP0	I
en#par#daquel	en#par#de+aquel	S+DMS	I
en#par#daquela	en#par#de+aquela	S+DFS	I
en#par#daquelas	en#par#de+aquelas	S+DFP	I
en#par#daqueles	en#par#de+aqueles	S+DMP	I
en#par#daqueloutra	en#par#de+aquela+outra	S+DFS+IFS0	I
en#par#daqueloutras	en#par#de+aquelas+outras	S+DFP+IFP0	I
en#par#daqueloutro	en#par#de+aquel+outro	S+DMS+IMS0	I
en#par#daqueloutros	en#par#de+aqueles+outros	S+DMP+IMP0	I
en#par#daquilo	en#par#de+aquilo	S+DNS	I
en#par#das	en#par#de+as	S+GFP	I
en#par#de	en#par#de	S	I
en#par#del	en#par#de+el	S+P3MSB0	I
en#par#dela	en#par#de+ela	S+P3FSB0	I
en#par#delas	en#par#de+elas	S+P3FPB0	I
en#par#deles	en#par#de+eles	S+P3MPB0	I
en#par#desa	en#par#de+esa	S+DFS	I
en#par#desas	en#par#de+esas	S+DFP	I
en#par#dese	en#par#de+ese	S+DMS	I
en#par#deses	en#par#de+eses	S+DMP	I
en#par#desoutra	en#par#de+esa+outra	S+DFS+IFS0	I
en#par#desoutras	en#par#de+esas+outras	S+DFP+IFP0	I
en#par#desoutro	en#par#de+ese+outro	S+DMS+IMS0	I
en#par#desoutros	en#par#de+eses+outros	S+DMP+IMP0	I
en#par#desta	en#par#de+esta	S+DFS	I
en#par#destas	en#par#de+estas	S+DFP	I
en#par#deste	en#par#de+este	S+DMS	I
en#par#destes	en#par#de+estes	S+DMP	I
en#par#destoutra	en#par#de+esta+outra	S+DFS+IFS0	I
en#par#destoutras	en#par#de+estas+outras	S+DFP+IFP0	I
en#par#destoutro	en#par#de+este+outro	S+DMS+IMS0	I
en#par#destoutros	en#par#de+estes+outros	S+DMP+IMP0	I
en#par#diso	en#par#de+iso	S+DNS	I
en#par#disto	en#par#de+isto	S+DNS	I
en#par#do	en#par#de+o	S+GMS	I
en#par#dos	en#par#de+os	S+GMP	I
en#par#doutra	en#par#de+outra	S+IFS0	I
en#par#doutras	en#par#de+outras	S+IFP0	I
en#par#doutro	en#par#de+outro	S+IMS0	I
en#par#doutros	en#par#de+outros	S+IMP0	I
en#par#dun	en#par#de+un	S+IMS0	I
en#par#dunha	en#par#de+unha	S+IFS0	I
en#par#dunhas	en#par#de+unhas	S+IFP0	I
en#par#duns	en#par#de+uns	S+IMP0	I
en#por#da	en#por#de+a	S+GFS	I
en#por#dalgún	en#por#de+algún	S+IMS0	I
en#por#dalgúns	en#por#de+algúns	S+IMP0	I
en#por#dalgunha	en#por#de+algunha	S+IFS0	I
en#por#dalgunhas	en#por#de+algunhas	S+IFP0	I
en#por#daquel	en#por#de+aquel	S+DMS	I
en#por#daquela	en#por#de+aquela	S+DFS	I
en#por#daquelas	en#por#de+aquelas	S+DFP	I
en#por#daqueles	en#por#de+aqueles	S+DMP	I
en#por#daqueloutra	en#por#de+aquela+outra	S+DFS+IFS0	I
en#por#daqueloutras	en#por#de+aquelas+outras	S+DFP+IFP0	I
en#por#daqueloutro	en#por#de+aquel+outro	S+DMS+IMS0	I
en#por#daqueloutros	en#por#de+aqueles+outros	S+DMP+IMP0	I
en#por#daquilo	en#por#de+aquilo	S+DNS	I
en#por#das	en#por#de+as	S+GFP	I
en#por#de	en#por#de	S	I
en#por#del	en#por#de+el	S+P3MSB0	I
en#por#dela	en#por#de+ela	S+P3FSB0	I
en#por#delas	en#por#de+elas	S+P3FPB0	I
en#por#deles	en#por#de+eles	S+P3MPB0	I
en#por#desa	en#por#de+esa	S+DFS	I
en#por#desas	en#por#de+esas	S+DFP	I
en#por#dese	en#por#de+ese	S+DMS	I
en#por#deses	en#por#de+eses	S+DMP	I
en#por#desoutra	en#por#de+esa+outra	S+DFS+IFS0	I
en#por#desoutras	en#por#de+esas+outras	S+DFP+IFP0	I
en#por#desoutro	en#por#de+ese+outro	S+DMS+IMS0	I
en#por#desoutros	en#por#de+eses+outros	S+DMP+IMP0	I
en#por#desta	en#por#de+esta	S+DFS	I
en#por#destas	en#por#de+estas	S+DFP	I
en#por#deste	en#por#de+este	S+DMS	I
en#por#destes	en#por#de+estes	S+DMP	I
en#por#destoutra	en#por#de+esta+outra	S+DFS+IFS0	I
en#por#destoutras	en#por#de+estas+outras	S+DFP+IFP0	I
en#por#destoutro	en#por#de+este+outro	S+DMS+IMS0	I
en#por#destoutros	en#por#de+estes+outros	S+DMP+IMP0	I
en#por#diso	en#por#de+iso	S+DNS	I
en#por#disto	en#por#de+isto	S+DNS	I
en#por#do	en#por#de+o	S+GMS	I
en#por#dos	en#por#de+os	S+GMP	I
en#por#doutra	en#por#de+outra	S+IFS0	I
en#por#doutras	en#por#de+outras	S+IFP0	I
en#por#doutro	en#por#de+outro	S+IMS0	I
en#por#doutros	en#por#de+outros	S+IMP0	I
en#por#dun	en#por#de+un	S+IMS0	I
en#por#dunha	en#por#de+unha	S+IFS0	I
en#por#dunhas	en#por#de+unhas	S+IFP0	I
en#por#duns	en#por#de+uns	S+IMP0	I
en#troques#da	en#troques#de+a	S+GFS	I
en#troques#dalgún	en#troques#de+algún	S+IMS0	I
en#troques#dalgúns	en#troques#de+algúns	S+IMP0	I
en#troques#dalgunha	en#troques#de+algunha	S+IFS0	I
en#troques#dalgunhas	en#troques#de+algunhas	S+IFP0	I
en#troques#daquel	en#troques#de+aquel	S+DMS	I
en#troques#daquela	en#troques#de+aquela	S+DFS	I
en#troques#daquelas	en#troques#de+aquelas	S+DFP	I
en#troques#daqueles	en#troques#de+aqueles	S+DMP	I
en#troques#daqueloutra	en#troques#de+aquela+outra	S+DFS+IFS0	I
en#troques#daqueloutras	en#troques#de+aquelas+outras	S+DFP+IFP0	I
en#troques#daqueloutro	en#troques#de+aquel+outro	S+DMS+IMS0	I
en#troques#daqueloutros	en#troques#de+aqueles+outros	S+DMP+IMP0	I
en#troques#daquilo	en#troques#de+aquilo	S+DNS	I
en#troques#das	en#troques#de+as	S+GFP	I
en#troques#de	en#troques#de	S	I
en#troques#del	en#troques#de+el	S+P3MSB0	I
en#troques#dela	en#troques#de+ela	S+P3FSB0	I
en#troques#delas	en#troques#de+elas	S+P3FPB0	I
en#troques#deles	en#troques#de+eles	S+P3MPB0	I
en#troques#desa	en#troques#de+esa	S+DFS	I
en#troques#desas	en#troques#de+esas	S+DFP	I
en#troques#dese	en#troques#de+ese	S+DMS	I
en#troques#deses	en#troques#de+eses	S+DMP	I
en#troques#desoutra	en#troques#de+esa+outra	S+DFS+IFS0	I
en#troques#desoutras	en#troques#de+esas+outras	S+DFP+IFP0	I
en#troques#desoutro	en#troques#de+ese+outro	S+DMS+IMS0	I
en#troques#desoutros	en#troques#de+eses+outros	S+DMP+IMP0	I
en#troques#desta	en#troques#de+esta	S+DFS	I
en#troques#destas	en#troques#de+estas	S+DFP	I
en#troques#deste	en#troques#de+este	S+DMS	I
en#troques#destes	en#troques#de+estes	S+DMP	I
en#troques#destoutra	en#troques#de+esta+outra	S+DFS+IFS0	I
en#troques#destoutras	en#troques#de+estas+outras	S+DFP+IFP0	I
en#troques#destoutro	en#troques#de+este+outro	S+DMS+IMS0	I
en#troques#destoutros	en#troques#de+estes+outros	S+DMP+IMP0	I
en#troques#diso	en#troques#de+iso	S+DNS	I
en#troques#disto	en#troques#de+isto	S+DNS	I
en#troques#do	en#troques#de+o	S+GMS	I
en#troques#dos	en#troques#de+os	S+GMP	I
en#troques#doutra	en#troques#de+outra	S+IFS0	I
en#troques#doutras	en#troques#de+outras	S+IFP0	I
en#troques#doutro	en#troques#de+outro	S+IMS0	I
en#troques#doutros	en#troques#de+outros	S+IMP0	I
en#troques#dun	en#troques#de+un	S+IMS0	I
en#troques#dunha	en#troques#de+unha	S+IFS0	I
en#troques#dunhas	en#troques#de+unhas	S+IFP0	I
en#troques#duns	en#troques#de+uns	S+IMP0	I
en#vez#da	en#vez#de+a	S+GFS	I
en#vez#dalgún	en#vez#de+algún	S+IMS0	I
en#vez#dalgúns	en#vez#de+algúns	S+IMP0	I
en#vez#dalgunha	en#vez#de+algunha	S+IFS0	I
en#vez#dalgunhas	en#vez#de+algunhas	S+IFP0	I
en#vez#daquel	en#vez#de+aquel	S+DMS	I
en#vez#daquela	en#vez#de+aquela	S+DFS	I
en#vez#daquelas	en#vez#de+aquelas	S+DFP	I
en#vez#daqueles	en#vez#de+aqueles	S+DMP	I
en#vez#daqueloutra	en#vez#de+aquela+outra	S+DFS+IFS0	I
en#vez#daqueloutras	en#vez#de+aquelas+outras	S+DFP+IFP0	I
en#vez#daqueloutro	en#vez#de+aquel+outro	S+DMS+IMS0	I
en#vez#daqueloutros	en#vez#de+aqueles+outros	S+DMP+IMP0	I
en#vez#daquilo	en#vez#de+aquilo	S+DNS	I
en#vez#das	en#vez#de+as	S+GFP	I
en#vez#de	en#vez#de	S	I
en#vez#del	en#vez#de+el	S+P3MSB0	I
en#vez#dela	en#vez#de+ela	S+P3FSB0	I
en#vez#delas	en#vez#de+elas	S+P3FPB0	I
en#vez#deles	en#vez#de+eles	S+P3MPB0	I
en#vez#desa	en#vez#de+esa	S+DFS	I
en#vez#desas	en#vez#de+esas	S+DFP	I
en#vez#dese	en#vez#de+ese	S+DMS	I
en#vez#deses	en#vez#de+eses	S+DMP	I
en#vez#desoutra	en#vez#de+esa+outra	S+DFS+IFS0	I
en#vez#desoutras	en#vez#de+esas+outras	S+DFP+IFP0	I
en#vez#desoutro	en#vez#de+ese+outro	S+DMS+IMS0	I
en#vez#desoutros	en#vez#de+eses+outros	S+DMP+IMP0	I
en#vez#desta	en#vez#de+esta	S+DFS	I
en#vez#destas	en#vez#de+estas	S+DFP	I
en#vez#deste	en#vez#de+este	S+DMS	I
en#vez#destes	en#vez#de+estes	S+DMP	I
en#vez#destoutra	en#vez#de+esta+outra	S+DFS+IFS0	I
en#vez#destoutras	en#vez#de+estas+outras	S+DFP+IFP0	I
en#vez#destoutro	en#vez#de+este+outro	S+DMS+IMS0	I
en#vez#destoutros	en#vez#de+estes+outros	S+DMP+IMP0	I
en#vez#diso	en#vez#de+iso	S+DNS	I
en#vez#disto	en#vez#de+isto	S+DNS	I
en#vez#do	en#vez#de+o	S+GMS	I
en#vez#dos	en#vez#de+os	S+GMP	I
en#vez#doutra	en#vez#de+outra	S+IFS0	I
en#vez#doutras	en#vez#de+outras	S+IFP0	I
en#vez#doutro	en#vez#de+outro	S+IMS0	I
en#vez#doutros	en#vez#de+outros	S+IMP0	I
en#vez#dun	en#vez#de+un	S+IMS0	I
en#vez#dunha	en#vez#de+unha	S+IFS0	I
en#vez#dunhas	en#vez#de+unhas	S+IFP0	I
en#vez#duns	en#vez#de+uns	S+IMP0	I
encima#da	encima#de+a	S+GFS	I
encima#dalgún	encima#de+algún	S+IMS0	I
encima#dalgúns	encima#de+algúns	S+IMP0	I
encima#dalgunha	encima#de+algunha	S+IFS0	I
encima#dalgunhas	encima#de+algunhas	S+IFP0	I
encima#daquel	encima#de+aquel	S+DMS	I
encima#daquela	encima#de+aquela	S+DFS	I
encima#daquelas	encima#de+aquelas	S+DFP	I
encima#daqueles	encima#de+aqueles	S+DMP	I
encima#daqueloutra	encima#de+aquela+outra	S+DFS+IFS0	I
encima#daqueloutras	encima#de+aquelas+outras	S+DFP+IFP0	I
encima#daqueloutro	encima#de+aquel+outro	S+DMS+IMS0	I
encima#daqueloutros	encima#de+aqueles+outros	S+DMP+IMP0	I
encima#daquilo	encima#de+aquilo	S+DNS	I
encima#das	encima#de+as	S+GFP	I
encima#de	encima#de	S	I
encima#del	encima#de+el	S+P3MSB0	I
encima#dela	encima#de+ela	S+P3FSB0	I
encima#delas	encima#de+elas	S+P3FPB0	I
encima#deles	encima#de+eles	S+P3MPB0	I
encima#desa	encima#de+esa	S+DFS	I
encima#desas	encima#de+esas	S+DFP	I
encima#dese	encima#de+ese	S+DMS	I
encima#deses	encima#de+eses	S+DMP	I
encima#desoutra	encima#de+esa+outra	S+DFS+IFS0	I
encima#desoutras	encima#de+esas+outras	S+DFP+IFP0	I
encima#desoutro	encima#de+ese+outro	S+DMS+IMS0	I
encima#desoutros	encima#de+eses+outros	S+DMP+IMP0	I
encima#desta	encima#de+esta	S+DFS	I
encima#destas	encima#de+estas	S+DFP	I
encima#deste	encima#de+este	S+DMS	I
encima#destes	encima#de+estes	S+DMP	I
encima#destoutra	encima#de+esta+outra	S+DFS+IFS0	I
encima#destoutras	encima#de+estas+outras	S+DFP+IFP0	I
encima#destoutro	encima#de+este+outro	S+DMS+IMS0	I
encima#destoutros	encima#de+estes+outros	S+DMP+IMP0	I
encima#diso	encima#de+iso	S+DNS	I
encima#disto	encima#de+isto	S+DNS	I
encima#do	encima#de+o	S+GMS	I
encima#dos	encima#de+os	S+GMP	I
encima#doutra	encima#de+outra	S+IFS0	I
encima#doutras	encima#de+outras	S+IFP0	I
encima#doutro	encima#de+outro	S+IMS0	I
encima#doutros	encima#de+outros	S+IMP0	I
encima#dun	encima#de+un	S+IMS0	I
encima#dunha	encima#de+unha	S+IFS0	I
encima#dunhas	encima#de+unhas	S+IFP0	I
encima#duns	encima#de+uns	S+IMP0	I
encol#da	encol#de+a	S+GFS	I
encol#dalgún	encol#de+algún	S+IMS0	I
encol#dalgúns	encol#de+algúns	S+IMP0	I
encol#dalgunha	encol#de+algunha	S+IFS0	I
encol#dalgunhas	encol#de+algunhas	S+IFP0	I
encol#daquel	encol#de+aquel	S+DMS	I
encol#daquela	encol#de+aquela	S+DFS	I
encol#daquelas	encol#de+aquelas	S+DFP	I
encol#daqueles	encol#de+aqueles	S+DMP	I
encol#daqueloutra	encol#de+aquela+outra	S+DFS+IFS0	I
encol#daqueloutras	encol#de+aquelas+outras	S+DFP+IFP0	I
encol#daqueloutro	encol#de+aquel+outro	S+DMS+IMS0	I
encol#daqueloutros	encol#de+aqueles+outros	S+DMP+IMP0	I
encol#daquilo	encol#de+aquilo	S+DNS	I
encol#das	encol#de+as	S+GFP	I
encol#de	encol#de	S	I
encol#del	encol#de+el	S+P3MSB0	I
encol#dela	encol#de+ela	S+P3FSB0	I
encol#delas	encol#de+elas	S+P3FPB0	I
encol#deles	encol#de+eles	S+P3MPB0	I
encol#desa	encol#de+esa	S+DFS	I
encol#desas	encol#de+esas	S+DFP	I
encol#dese	encol#de+ese	S+DMS	I
encol#deses	encol#de+eses	S+DMP	I
encol#desoutra	encol#de+esa+outra	S+DFS+IFS0	I
encol#desoutras	encol#de+esas+outras	S+DFP+IFP0	I
encol#desoutro	encol#de+ese+outro	S+DMS+IMS0	I
encol#desoutros	encol#de+eses+outros	S+DMP+IMP0	I
encol#desta	encol#de+esta	S+DFS	I
encol#destas	encol#de+estas	S+DFP	I
encol#deste	encol#de+este	S+DMS	I
encol#destes	encol#de+estes	S+DMP	I
encol#destoutra	encol#de+esta+outra	S+DFS+IFS0	I
encol#destoutras	encol#de+estas+outras	S+DFP+IFP0	I
encol#destoutro	encol#de+este+outro	S+DMS+IMS0	I
encol#destoutros	encol#de+estes+outros	S+DMP+IMP0	I
encol#diso	encol#de+iso	S+DNS	I
encol#disto	encol#de+isto	S+DNS	I
encol#do	encol#de+o	S+GMS	I
encol#dos	encol#de+os	S+GMP	I
encol#doutra	encol#de+outra	S+IFS0	I
encol#doutras	encol#de+outras	S+IFP0	I
encol#doutro	encol#de+outro	S+IMS0	I
encol#doutros	encol#de+outros	S+IMP0	I
encol#dun	encol#de+un	S+IMS0	I
encol#dunha	encol#de+unha	S+IFS0	I
encol#dunhas	encol#de+unhas	S+IFP0	I
encol#duns	encol#de+uns	S+IMP0	I
enriba#da	enriba#de+a	S+GFS	I
enriba#dalgún	enriba#de+algún	S+IMS0	I
enriba#dalgúns	enriba#de+algúns	S+IMP0	I
enriba#dalgunha	enriba#de+algunha	S+IFS0	I
enriba#dalgunhas	enriba#de+algunhas	S+IFP0	I
enriba#daquel	enriba#de+aquel	S+DMS	I
enriba#daquela	enriba#de+aquela	S+DFS	I
enriba#daquelas	enriba#de+aquelas	S+DFP	I
enriba#daqueles	enriba#de+aqueles	S+DMP	I
enriba#daqueloutra	enriba#de+aquela+outra	S+DFS+IFS0	I
enriba#daqueloutras	enriba#de+aquelas+outras	S+DFP+IFP0	I
enriba#daqueloutro	enriba#de+aquel+outro	S+DMS+IMS0	I
enriba#daqueloutros	enriba#de+aqueles+outros	S+DMP+IMP0	I
enriba#daquilo	enriba#de+aquilo	S+DNS	I
enriba#das	enriba#de+as	S+GFP	I
enriba#de	enriba#de	S	I
enriba#del	enriba#de+el	S+P3MSB0	I
enriba#dela	enriba#de+ela	S+P3FSB0	I
enriba#delas	enriba#de+elas	S+P3FPB0	I
enriba#deles	enriba#de+eles	S+P3MPB0	I
enriba#desa	enriba#de+esa	S+DFS	I
enriba#desas	enriba#de+esas	S+DFP	I
enriba#dese	enriba#de+ese	S+DMS	I
enriba#deses	enriba#de+eses	S+DMP	I
enriba#desoutra	enriba#de+esa+outra	S+DFS+IFS0	I
enriba#desoutras	enriba#de+esas+outras	S+DFP+IFP0	I
enriba#desoutro	enriba#de+ese+outro	S+DMS+IMS0	I
enriba#desoutros	enriba#de+eses+outros	S+DMP+IMP0	I
enriba#desta	enriba#de+esta	S+DFS	I
enriba#destas	enriba#de+estas	S+DFP	I
enriba#deste	enriba#de+este	S+DMS	I
enriba#destes	enriba#de+estes	S+DMP	I
enriba#destoutra	enriba#de+esta+outra	S+DFS+IFS0	I
enriba#destoutras	enriba#de+estas+outras	S+DFP+IFP0	I
enriba#destoutro	enriba#de+este+outro	S+DMS+IMS0	I
enriba#destoutros	enriba#de+estes+outros	S+DMP+IMP0	I
enriba#diso	enriba#de+iso	S+DNS	I
enriba#disto	enriba#de+isto	S+DNS	I
enriba#do	enriba#de+o	S+GMS	I
enriba#dos	enriba#de+os	S+GMP	I
enriba#doutra	enriba#de+outra	S+IFS0	I
enriba#doutras	enriba#de+outras	S+IFP0	I
enriba#doutro	enriba#de+outro	S+IMS0	I
enriba#doutros	enriba#de+outros	S+IMP0	I
enriba#dun	enriba#de+un	S+IMS0	I
enriba#dunha	enriba#de+unha	S+IFS0	I
enriba#dunhas	enriba#de+unhas	S+IFP0	I
enriba#duns	enriba#de+uns	S+IMP0	I
fóra#da	fóra#de+a	S+GFS	I
fóra#dalgún	fóra#de+algún	S+IMS0	I
fóra#dalgúns	fóra#de+algúns	S+IMP0	I
fóra#dalgunha	fóra#de+algunha	S+IFS0	I
fóra#dalgunhas	fóra#de+algunhas	S+IFP0	I
fóra#daquel	fóra#de+aquel	S+DMS	I
fóra#daquela	fóra#de+aquela	S+DFS	I
fóra#daquelas	fóra#de+aquelas	S+DFP	I
fóra#daqueles	fóra#de+aqueles	S+DMP	I
fóra#daqueloutra	fóra#de+aquela+outra	S+DFS+IFS0	I
fóra#daqueloutras	fóra#de+aquelas+outras	S+DFP+IFP0	I
fóra#daqueloutro	fóra#de+aquel+outro	S+DMS+IMS0	I
fóra#daqueloutros	fóra#de+aqueles+outros	S+DMP+IMP0	I
fóra#daquilo	fóra#de+aquilo	S+DNS	I
fóra#das	fóra#de+as	S+GFP	I
fóra#de	fóra#de	S	I
fóra#del	fóra#de+el	S+P3MSB0	I
fóra#dela	fóra#de+ela	S+P3FSB0	I
fóra#delas	fóra#de+elas	S+P3FPB0	I
fóra#deles	fóra#de+eles	S+P3MPB0	I
fóra#desa	fóra#de+esa	S+DFS	I
fóra#desas	fóra#de+esas	S+DFP	I
fóra#dese	fóra#de+ese	S+DMS	I
fóra#deses	fóra#de+eses	S+DMP	I
fóra#desoutra	fóra#de+esa+outra	S+DFS+IFS0	I
fóra#desoutras	fóra#de+esas+outras	S+DFP+IFP0	I
fóra#desoutro	fóra#de+ese+outro	S+DMS+IMS0	I
fóra#desoutros	fóra#de+eses+outros	S+DMP+IMP0	I
fóra#desta	fóra#de+esta	S+DFS	I
fóra#destas	fóra#de+estas	S+DFP	I
fóra#deste	fóra#de+este	S+DMS	I
fóra#destes	fóra#de+estes	S+DMP	I
fóra#destoutra	fóra#de+esta+outra	S+DFS+IFS0	I
fóra#destoutras	fóra#de+estas+outras	S+DFP+IFP0	I
fóra#destoutro	fóra#de+este+outro	S+DMS+IMS0	I
fóra#destoutros	fóra#de+estes+outros	S+DMP+IMP0	I
fóra#diso	fóra#de+iso	S+DNS	I
fóra#disto	fóra#de+isto	S+DNS	I
fóra#do	fóra#de+o	S+GMS	I
fóra#dos	fóra#de+os	S+GMP	I
fóra#doutra	fóra#de+outra	S+IFS0	I
fóra#doutras	fóra#de+outras	S+IFP0	I
fóra#doutro	fóra#de+outro	S+IMS0	I
fóra#doutros	fóra#de+outros	S+IMP0	I
fóra#dun	fóra#de+un	S+IMS0	I
fóra#dunha	fóra#de+unha	S+IFS0	I
fóra#dunhas	fóra#de+unhas	S+IFP0	I
fóra#duns	fóra#de+uns	S+IMP0	I
fronte#á	fronte#a+a	S+GFS	I
fronte#ás	fronte#a+as	S+GFP	I
fronte#ó	fronte#a+o	S+GMS	I
fronte#a	fronte#a	S	I
fronte#ao	fronte#a+o	S+GMS	I
fronte#aos	fronte#a+os	S+GMP	I
lonxe#da	lonxe#de+a	S+GFS	I
lonxe#dalgún	lonxe#de+algún	S+IMS0	I
lonxe#dalgúns	lonxe#de+algúns	S+IMP0	I
lonxe#dalgunha	lonxe#de+algunha	S+IFS0	I
lonxe#dalgunhas	lonxe#de+algunhas	S+IFP0	I
lonxe#daquel	lonxe#de+aquel	S+DMS	I
lonxe#daquela	lonxe#de+aquela	S+DFS	I
lonxe#daquelas	lonxe#de+aquelas	S+DFP	I
lonxe#daqueles	lonxe#de+aqueles	S+DMP	I
lonxe#daqueloutra	lonxe#de+aquela+outra	S+DFS+IFS0	I
lonxe#daqueloutras	lonxe#de+aquelas+outras	S+DFP+IFP0	I
lonxe#daqueloutro	lonxe#de+aquel+outro	S+DMS+IMS0	I
lonxe#daqueloutros	lonxe#de+aqueles+outros	S+DMP+IMP0	I
lonxe#daquilo	lonxe#de+aquilo	S+DNS	I
lonxe#das	lonxe#de+as	S+GFP	I
lonxe#de	lonxe#de	S	I
lonxe#del	lonxe#de+el	S+P3MSB0	I
lonxe#dela	lonxe#de+ela	S+P3FSB0	I
lonxe#delas	lonxe#de+elas	S+P3FPB0	I
lonxe#deles	lonxe#de+eles	S+P3MPB0	I
lonxe#desa	lonxe#de+esa	S+DFS	I
lonxe#desas	lonxe#de+esas	S+DFP	I
lonxe#dese	lonxe#de+ese	S+DMS	I
lonxe#deses	lonxe#de+eses	S+DMP	I
lonxe#desoutra	lonxe#de+esa+outra	S+DFS+IFS0	I
lonxe#desoutras	lonxe#de+esas+outras	S+DFP+IFP0	I
lonxe#desoutro	lonxe#de+ese+outro	S+DMS+IMS0	I
lonxe#desoutros	lonxe#de+eses+outros	S+DMP+IMP0	I
lonxe#desta	lonxe#de+esta	S+DFS	I
lonxe#destas	lonxe#de+estas	S+DFP	I
lonxe#deste	lonxe#de+este	S+DMS	I
lonxe#destes	lonxe#de+estes	S+DMP	I
lonxe#destoutra	lonxe#de+esta+outra	S+DFS+IFS0	I
lonxe#destoutras	lonxe#de+estas+outras	S+DFP+IFP0	I
lonxe#destoutro	lonxe#de+este+outro	S+DMS+IMS0	I
lonxe#destoutros	lonxe#de+estes+outros	S+DMP+IMP0	I
lonxe#diso	lonxe#de+iso	S+DNS	I
lonxe#disto	lonxe#de+isto	S+DNS	I
lonxe#do	lonxe#de+o	S+GMS	I
lonxe#dos	lonxe#de+os	S+GMP	I
lonxe#doutra	lonxe#de+outra	S+IFS0	I
lonxe#doutras	lonxe#de+outras	S+IFP0	I
lonxe#doutro	lonxe#de+outro	S+IMS0	I
lonxe#doutros	lonxe#de+outros	S+IMP0	I
lonxe#dun	lonxe#de+un	S+IMS0	I
lonxe#dunha	lonxe#de+unha	S+IFS0	I
lonxe#dunhas	lonxe#de+unhas	S+IFP0	I
lonxe#duns	lonxe#de+uns	S+IMP0	I
no#canto#da	no#canto#de+a	S+GFS	I
no#canto#dalgún	no#canto#de+algún	S+IMS0	I
no#canto#dalgúns	no#canto#de+algúns	S+IMP0	I
no#canto#dalgunha	no#canto#de+algunha	S+IFS0	I
no#canto#dalgunhas	no#canto#de+algunhas	S+IFP0	I
no#canto#daquel	no#canto#de+aquel	S+DMS	I
no#canto#daquela	no#canto#de+aquela	S+DFS	I
no#canto#daquelas	no#canto#de+aquelas	S+DFP	I
no#canto#daqueles	no#canto#de+aqueles	S+DMP	I
no#canto#daqueloutra	no#canto#de+aquela+outra	S+DFS+IFS0	I
no#canto#daqueloutras	no#canto#de+aquelas+outras	S+DFP+IFP0	I
no#canto#daqueloutro	no#canto#de+aquel+outro	S+DMS+IMS0	I
no#canto#daqueloutros	no#canto#de+aqueles+outros	S+DMP+IMP0	I
no#canto#daquilo	no#canto#de+aquilo	S+DNS	I
no#canto#das	no#canto#de+as	S+GFP	I
no#canto#de	no#canto#de	S	I
no#canto#del	no#canto#de+el	S+P3MSB0	I
no#canto#dela	no#canto#de+ela	S+P3FSB0	I
no#canto#delas	no#canto#de+elas	S+P3FPB0	I
no#canto#deles	no#canto#de+eles	S+P3MPB0	I
no#canto#desa	no#canto#de+esa	S+DFS	I
no#canto#desas	no#canto#de+esas	S+DFP	I
no#canto#dese	no#canto#de+ese	S+DMS	I
no#canto#deses	no#canto#de+eses	S+DMP	I
no#canto#desoutra	no#canto#de+esa+outra	S+DFS+IFS0	I
no#canto#desoutras	no#canto#de+esas+outras	S+DFP+IFP0	I
no#canto#desoutro	no#canto#de+ese+outro	S+DMS+IMS0	I
no#canto#desoutros	no#canto#de+eses+outros	S+DMP+IMP0	I
no#canto#desta	no#canto#de+esta	S+DFS	I
no#canto#destas	no#canto#de+estas	S+DFP	I
no#canto#deste	no#canto#de+este	S+DMS	I
no#canto#destes	no#canto#de+estes	S+DMP	I
no#canto#destoutra	no#canto#de+esta+outra	S+DFS+IFS0	I
no#canto#destoutras	no#canto#de+estas+outras	S+DFP+IFP0	I
no#canto#destoutro	no#canto#de+este+outro	S+DMS+IMS0	I
no#canto#destoutros	no#canto#de+estes+outros	S+DMP+IMP0	I
no#canto#diso	no#canto#de+iso	S+DNS	I
no#canto#disto	no#canto#de+isto	S+DNS	I
no#canto#do	no#canto#de+o	S+GMS	I
no#canto#dos	no#canto#de+os	S+GMP	I
no#canto#doutra	no#canto#de+outra	S+IFS0	I
no#canto#doutras	no#canto#de+outras	S+IFP0	I
no#canto#doutro	no#canto#de+outro	S+IMS0	I
no#canto#doutros	no#canto#de+outros	S+IMP0	I
no#canto#dun	no#canto#de+un	S+IMS0	I
no#canto#dunha	no#canto#de+unha	S+IFS0	I
no#canto#dunhas	no#canto#de+unhas	S+IFP0	I
no#canto#duns	no#canto#de+uns	S+IMP0	I
pese#á	pese#a+a	S+GFS	I
pese#ás	pese#a+as	S+GFP	I
pese#ó	pese#a+o	S+GMS	I
pese#a	pese#a	S	I
pese#ao	pese#a+o	S+GMS	I
pese#aos	pese#a+os	S+GMP	I
por#ante	por#ante	S	I
por#cousa#da	por#cousa#de+a	S+GFS	I
por#cousa#dalgún	por#cousa#de+algún	S+IMS0	I
por#cousa#dalgúns	por#cousa#de+algúns	S+IMP0	I
por#cousa#dalgunha	por#cousa#de+algunha	S+IFS0	I
por#cousa#dalgunhas	por#cousa#de+algunhas	S+IFP0	I
por#cousa#daquel	por#cousa#de+aquel	S+DMS	I
por#cousa#daquela	por#cousa#de+aquela	S+DFS	I
por#cousa#daquelas	por#cousa#de+aquelas	S+DFP	I
por#cousa#daqueles	por#cousa#de+aqueles	S+DMP	I
por#cousa#daqueloutra	por#cousa#de+aquela+outra	S+DFS+IFS0	I
por#cousa#daqueloutras	por#cousa#de+aquelas+outras	S+DFP+IFP0	I
por#cousa#daqueloutro	por#cousa#de+aquel+outro	S+DMS+IMS0	I
por#cousa#daqueloutros	por#cousa#de+aqueles+outros	S+DMP+IMP0	I
por#cousa#daquilo	por#cousa#de+aquilo	S+DNS	I
por#cousa#das	por#cousa#de+as	S+GFP	I
por#cousa#de	por#cousa#de	S	I
por#cousa#del	por#cousa#de+el	S+P3MSB0	I
por#cousa#dela	por#cousa#de+ela	S+P3FSB0	I
por#cousa#delas	por#cousa#de+elas	S+P3FPB0	I
por#cousa#deles	por#cousa#de+eles	S+P3MPB0	I
por#cousa#desa	por#cousa#de+esa	S+DFS	I
por#cousa#desas	por#cousa#de+esas	S+DFP	I
por#cousa#dese	por#cousa#de+ese	S+DMS	I
por#cousa#deses	por#cousa#de+eses	S+DMP	I
por#cousa#desoutra	por#cousa#de+esa+outra	S+DFS+IFS0	I
por#cousa#desoutras	por#cousa#de+esas+outras	S+DFP+IFP0	I
por#cousa#desoutro	por#cousa#de+ese+outro	S+DMS+IMS0	I
por#cousa#desoutros	por#cousa#de+eses+outros	S+DMP+IMP0	I
por#cousa#desta	por#cousa#de+esta	S+DFS	I
por#cousa#destas	por#cousa#de+estas	S+DFP	I
por#cousa#deste	por#cousa#de+este	S+DMS	I
por#cousa#destes	por#cousa#de+estes	S+DMP	I
por#cousa#destoutra	por#cousa#de+esta+outra	S+DFS+IFS0	I
por#cousa#destoutras	por#cousa#de+estas+outras	S+DFP+IFP0	I
por#cousa#destoutro	por#cousa#de+este+outro	S+DMS+IMS0	I
por#cousa#destoutros	por#cousa#de+estes+outros	S+DMP+IMP0	I
por#cousa#diso	por#cousa#de+iso	S+DNS	I
por#cousa#disto	por#cousa#de+isto	S+DNS	I
por#cousa#do	por#cousa#de+o	S+GMS	I
por#cousa#dos	por#cousa#de+os	S+GMP	I
por#cousa#doutra	por#cousa#de+outra	S+IFS0	I
por#cousa#doutras	por#cousa#de+outras	S+IFP0	I
por#cousa#doutro	por#cousa#de+outro	S+IMS0	I
por#cousa#doutros	por#cousa#de+outros	S+IMP0	I
por#cousa#dun	por#cousa#de+un	S+IMS0	I
por#cousa#dunha	por#cousa#de+unha	S+IFS0	I
por#cousa#dunhas	por#cousa#de+unhas	S+IFP0	I
por#cousa#duns	por#cousa#de+uns	S+IMP0	I
por#culpa#da	por#culpa#de+a	S+GFS	I
por#culpa#dalgún	por#culpa#de+algún	S+IMS0	I
por#culpa#dalgúns	por#culpa#de+algúns	S+IMP0	I
por#culpa#dalgunha	por#culpa#de+algunha	S+IFS0	I
por#culpa#dalgunhas	por#culpa#de+algunhas	S+IFP0	I
por#culpa#daquel	por#culpa#de+aquel	S+DMS	I
por#culpa#daquela	por#culpa#de+aquela	S+DFS	I
por#culpa#daquelas	por#culpa#de+aquelas	S+DFP	I
por#culpa#daqueles	por#culpa#de+aqueles	S+DMP	I
por#culpa#daqueloutra	por#culpa#de+aquela+outra	S+DFS+IFS0	I
por#culpa#daqueloutras	por#culpa#de+aquelas+outras	S+DFP+IFP0	I
por#culpa#daqueloutro	por#culpa#de+aquel+outro	S+DMS+IMS0	I
por#culpa#daqueloutros	por#culpa#de+aqueles+outros	S+DMP+IMP0	I
por#culpa#daquilo	por#culpa#de+aquilo	S+DNS	I
por#culpa#das	por#culpa#de+as	S+GFP	I
por#culpa#de	por#culpa#de	S	I
por#culpa#del	por#culpa#de+el	S+P3MSB0	I
por#culpa#dela	por#culpa#de+ela	S+P3FSB0	I
por#culpa#delas	por#culpa#de+elas	S+P3FPB0	I
por#culpa#deles	por#culpa#de+eles	S+P3MPB0	I
por#culpa#desa	por#culpa#de+esa	S+DFS	I
por#culpa#desas	por#culpa#de+esas	S+DFP	I
por#culpa#dese	por#culpa#de+ese	S+DMS	I
por#culpa#deses	por#culpa#de+eses	S+DMP	I
por#culpa#desoutra	por#culpa#de+esa+outra	S+DFS+IFS0	I
por#culpa#desoutras	por#culpa#de+esas+outras	S+DFP+IFP0	I
por#culpa#desoutro	por#culpa#de+ese+outro	S+DMS+IMS0	I
por#culpa#desoutros	por#culpa#de+eses+outros	S+DMP+IMP0	I
por#culpa#desta	por#culpa#de+esta	S+DFS	I
por#culpa#destas	por#culpa#de+estas	S+DFP	I
por#culpa#deste	por#culpa#de+este	S+DMS	I
por#culpa#destes	por#culpa#de+estes	S+DMP	I
por#culpa#destoutra	por#culpa#de+esta+outra	S+DFS+IFS0	I
por#culpa#destoutras	por#culpa#de+estas+outras	S+DFP+IFP0	I
por#culpa#destoutro	por#culpa#de+este+outro	S+DMS+IMS0	I
por#culpa#destoutros	por#culpa#de+estes+outros	S+DMP+IMP0	I
por#culpa#diso	por#culpa#de+iso	S+DNS	I
por#culpa#disto	por#culpa#de+isto	S+DNS	I
por#culpa#do	por#culpa#de+o	S+GMS	I
por#culpa#dos	por#culpa#de+os	S+GMP	I
por#culpa#doutra	por#culpa#de+outra	S+IFS0	I
por#culpa#doutras	por#culpa#de+outras	S+IFP0	I
por#culpa#doutro	por#culpa#de+outro	S+IMS0	I
por#culpa#doutros	por#culpa#de+outros	S+IMP0	I
por#culpa#dun	por#culpa#de+un	S+IMS0	I
por#culpa#dunha	por#culpa#de+unha	S+IFS0	I
por#culpa#dunhas	por#culpa#de+unhas	S+IFP0	I
por#culpa#duns	por#culpa#de+uns	S+IMP0	I
por#medio#da	por#medio#de+a	S+GFS	I
por#medio#dalgún	por#medio#de+algún	S+IMS0	I
por#medio#dalgúns	por#medio#de+algúns	S+IMP0	I
por#medio#dalgunha	por#medio#de+algunha	S+IFS0	I
por#medio#dalgunhas	por#medio#de+algunhas	S+IFP0	I
por#medio#daquel	por#medio#de+aquel	S+DMS	I
por#medio#daquela	por#medio#de+aquela	S+DFS	I
por#medio#daquelas	por#medio#de+aquelas	S+DFP	I
por#medio#daqueles	por#medio#de+aqueles	S+DMP	I
por#medio#daqueloutra	por#medio#de+aquela+outra	S+DFS+IFS0	I
por#medio#daqueloutras	por#medio#de+aquelas+outras	S+DFP+IFP0	I
por#medio#daqueloutro	por#medio#de+aquel+outro	S+DMS+IMS0	I
por#medio#daqueloutros	por#medio#de+aqueles+outros	S+DMP+IMP0	I
por#medio#daquilo	por#medio#de+aquilo	S+DNS	I
por#medio#das	por#medio#de+as	S+GFP	I
por#medio#de	por#medio#de	S	I
por#medio#del	por#medio#de+el	S+P3MSB0	I
por#medio#dela	por#medio#de+ela	S+P3FSB0	I
por#medio#delas	por#medio#de+elas	S+P3FPB0	I
por#medio#deles	por#medio#de+eles	S+P3MPB0	I
por#medio#desa	por#medio#de+esa	S+DFS	I
por#medio#desas	por#medio#de+esas	S+DFP	I
por#medio#dese	por#medio#de+ese	S+DMS	I
por#medio#deses	por#medio#de+eses	S+DMP	I
por#medio#desoutra	por#medio#de+esa+outra	S+DFS+IFS0	I
por#medio#desoutras	por#medio#de+esas+outras	S+DFP+IFP0	I
por#medio#desoutro	por#medio#de+ese+outro	S+DMS+IMS0	I
por#medio#desoutros	por#medio#de+eses+outros	S+DMP+IMP0	I
por#medio#desta	por#medio#de+esta	S+DFS	I
por#medio#destas	por#medio#de+estas	S+DFP	I
por#medio#deste	por#medio#de+este	S+DMS	I
por#medio#destes	por#medio#de+estes	S+DMP	I
por#medio#destoutra	por#medio#de+esta+outra	S+DFS+IFS0	I
por#medio#destoutras	por#medio#de+estas+outras	S+DFP+IFP0	I
por#medio#destoutro	por#medio#de+este+outro	S+DMS+IMS0	I
por#medio#destoutros	por#medio#de+estes+outros	S+DMP+IMP0	I
por#medio#diso	por#medio#de+iso	S+DNS	I
por#medio#disto	por#medio#de+isto	S+DNS	I
por#medio#do	por#medio#de+o	S+GMS	I
por#medio#dos	por#medio#de+os	S+GMP	I
por#medio#doutra	por#medio#de+outra	S+IFS0	I
por#medio#doutras	por#medio#de+outras	S+IFP0	I
por#medio#doutro	por#medio#de+outro	S+IMS0	I
por#medio#doutros	por#medio#de+outros	S+IMP0	I
por#medio#dun	por#medio#de+un	S+IMS0	I
por#medio#dunha	por#medio#de+unha	S+IFS0	I
por#medio#dunhas	por#medio#de+unhas	S+IFP0	I
por#medio#duns	por#medio#de+uns	S+IMP0	I
por#mor#da	por#mor#de+a	S+GFS	I
por#mor#dalgún	por#mor#de+algún	S+IMS0	I
por#mor#dalgúns	por#mor#de+algúns	S+IMP0	I
por#mor#dalgunha	por#mor#de+algunha	S+IFS0	I
por#mor#dalgunhas	por#mor#de+algunhas	S+IFP0	I
por#mor#daquel	por#mor#de+aquel	S+DMS	I
por#mor#daquela	por#mor#de+aquela	S+DFS	I
por#mor#daquelas	por#mor#de+aquelas	S+DFP	I
por#mor#daqueles	por#mor#de+aqueles	S+DMP	I
por#mor#daqueloutra	por#mor#de+aquela+outra	S+DFS+IFS0	I
por#mor#daqueloutras	por#mor#de+aquelas+outras	S+DFP+IFP0	I
por#mor#daqueloutro	por#mor#de+aquel+outro	S+DMS+IMS0	I
por#mor#daqueloutros	por#mor#de+aqueles+outros	S+DMP+IMP0	I
por#mor#daquilo	por#mor#de+aquilo	S+DNS	I
por#mor#das	por#mor#de+as	S+GFP	I
por#mor#de	por#mor#de	S	I
por#mor#del	por#mor#de+el	S+P3MSB0	I
por#mor#dela	por#mor#de+ela	S+P3FSB0	I
por#mor#delas	por#mor#de+elas	S+P3FPB0	I
por#mor#deles	por#mor#de+eles	S+P3MPB0	I
por#mor#desa	por#mor#de+esa	S+DFS	I
por#mor#desas	por#mor#de+esas	S+DFP	I
por#mor#dese	por#mor#de+ese	S+DMS	I
por#mor#deses	por#mor#de+eses	S+DMP	I
por#mor#desoutra	por#mor#de+esa+outra	S+DFS+IFS0	I
por#mor#desoutras	por#mor#de+esas+outras	S+DFP+IFP0	I
por#mor#desoutro	por#mor#de+ese+outro	S+DMS+IMS0	I
por#mor#desoutros	por#mor#de+eses+outros	S+DMP+IMP0	I
por#mor#desta	por#mor#de+esta	S+DFS	I
por#mor#destas	por#mor#de+estas	S+DFP	I
por#mor#deste	por#mor#de+este	S+DMS	I
por#mor#destes	por#mor#de+estes	S+DMP	I
por#mor#destoutra	por#mor#de+esta+outra	S+DFS+IFS0	I
por#mor#destoutras	por#mor#de+estas+outras	S+DFP+IFP0	I
por#mor#destoutro	por#mor#de+este+outro	S+DMS+IMS0	I
por#mor#destoutros	por#mor#de+estes+outros	S+DMP+IMP0	I
por#mor#diso	por#mor#de+iso	S+DNS	I
por#mor#disto	por#mor#de+isto	S+DNS	I
por#mor#do	por#mor#de+o	S+GMS	I
por#mor#dos	por#mor#de+os	S+GMP	I
por#mor#doutra	por#mor#de+outra	S+IFS0	I
por#mor#doutras	por#mor#de+outras	S+IFP0	I
por#mor#doutro	por#mor#de+outro	S+IMS0	I
por#mor#doutros	por#mor#de+outros	S+IMP0	I
por#mor#dun	por#mor#de+un	S+IMS0	I
por#mor#dunha	por#mor#de+unha	S+IFS0	I
por#mor#dunhas	por#mor#de+unhas	S+IFP0	I
por#mor#duns	por#mor#de+uns	S+IMP0	I
preto#da	preto#de+a	S+GFS	I
preto#dalgún	preto#de+algún	S+IMS0	I
preto#dalgúns	preto#de+algúns	S+IMP0	I
preto#dalgunha	preto#de+algunha	S+IFS0	I
preto#dalgunhas	preto#de+algunhas	S+IFP0	I
preto#daquel	preto#de+aquel	S+DMS	I
preto#daquela	preto#de+aquela	S+DFS	I
preto#daquelas	preto#de+aquelas	S+DFP	I
preto#daqueles	preto#de+aqueles	S+DMP	I
preto#daqueloutra	preto#de+aquela+outra	S+DFS+IFS0	I
preto#daqueloutras	preto#de+aquelas+outras	S+DFP+IFP0	I
preto#daqueloutro	preto#de+aquel+outro	S+DMS+IMS0	I
preto#daqueloutros	preto#de+aqueles+outros	S+DMP+IMP0	I
preto#daquilo	preto#de+aquilo	S+DNS	I
preto#das	preto#de+as	S+GFP	I
preto#de	preto#de	S	I
preto#del	preto#de+el	S+P3MSB0	I
preto#dela	preto#de+ela	S+P3FSB0	I
preto#delas	preto#de+elas	S+P3FPB0	I
preto#deles	preto#de+eles	S+P3MPB0	I
preto#desa	preto#de+esa	S+DFS	I
preto#desas	preto#de+esas	S+DFP	I
preto#dese	preto#de+ese	S+DMS	I
preto#deses	preto#de+eses	S+DMP	I
preto#desoutra	preto#de+esa+outra	S+DFS+IFS0	I
preto#desoutras	preto#de+esas+outras	S+DFP+IFP0	I
preto#desoutro	preto#de+ese+outro	S+DMS+IMS0	I
preto#desoutros	preto#de+eses+outros	S+DMP+IMP0	I
preto#desta	preto#de+esta	S+DFS	I
preto#destas	preto#de+estas	S+DFP	I
preto#deste	preto#de+este	S+DMS	I
preto#destes	preto#de+estes	S+DMP	I
preto#destoutra	preto#de+esta+outra	S+DFS+IFS0	I
preto#destoutras	preto#de+estas+outras	S+DFP+IFP0	I
preto#destoutro	preto#de+este+outro	S+DMS+IMS0	I
preto#destoutros	preto#de+estes+outros	S+DMP+IMP0	I
preto#diso	preto#de+iso	S+DNS	I
preto#disto	preto#de+isto	S+DNS	I
preto#do	preto#de+o	S+GMS	I
preto#dos	preto#de+os	S+GMP	I
preto#doutra	preto#de+outra	S+IFS0	I
preto#doutras	preto#de+outras	S+IFP0	I
preto#doutro	preto#de+outro	S+IMS0	I
preto#doutros	preto#de+outros	S+IMP0	I
preto#dun	preto#de+un	S+IMS0	I
preto#dunha	preto#de+unha	S+IFS0	I
preto#dunhas	preto#de+unhas	S+IFP0	I
preto#duns	preto#de+uns	S+IMP0	I
respecto#á	respecto#a+a	S+GFS	I
respecto#ás	respecto#a+as	S+GFP	I
respecto#ó	respecto#a+o	S+GMS	I
respecto#a	respecto#a	S	I
respecto#ao	respecto#a+o	S+GMS	I
respecto#aos	respecto#a+os	S+GMP	I
respecto#da	respecto#de+a	S+GFS	I
respecto#dalgún	respecto#de+algún	S+IMS0	I
respecto#dalgúns	respecto#de+algúns	S+IMP0	I
respecto#dalgunha	respecto#de+algunha	S+IFS0	I
respecto#dalgunhas	respecto#de+algunhas	S+IFP0	I
respecto#daquel	respecto#de+aquel	S+DMS	I
respecto#daquela	respecto#de+aquela	S+DFS	I
respecto#daquelas	respecto#de+aquelas	S+DFP	I
respecto#daqueles	respecto#de+aqueles	S+DMP	I
respecto#daqueloutra	respecto#de+aquela+outra	S+DFS+IFS0	I
respecto#daqueloutras	respecto#de+aquelas+outras	S+DFP+IFP0	I
respecto#daqueloutro	respecto#de+aquel+outro	S+DMS+IMS0	I
respecto#daqueloutros	respecto#de+aqueles+outros	S+DMP+IMP0	I
respecto#daquilo	respecto#de+aquilo	S+DNS	I
respecto#das	respecto#de+as	S+GFP	I
respecto#de	respecto#de	S	I
respecto#del	respecto#de+el	S+P3MSB0	I
respecto#dela	respecto#de+ela	S+P3FSB0	I
respecto#delas	respecto#de+elas	S+P3FPB0	I
respecto#deles	respecto#de+eles	S+P3MPB0	I
respecto#desa	respecto#de+esa	S+DFS	I
respecto#desas	respecto#de+esas	S+DFP	I
respecto#dese	respecto#de+ese	S+DMS	I
respecto#deses	respecto#de+eses	S+DMP	I
respecto#desoutra	respecto#de+esa+outra	S+DFS+IFS0	I
respecto#desoutras	respecto#de+esas+outras	S+DFP+IFP0	I
respecto#desoutro	respecto#de+ese+outro	S+DMS+IMS0	I
respecto#desoutros	respecto#de+eses+outros	S+DMP+IMP0	I
respecto#desta	respecto#de+esta	S+DFS	I
respecto#destas	respecto#de+estas	S+DFP	I
respecto#deste	respecto#de+este	S+DMS	I
respecto#destes	respecto#de+estes	S+DMP	I
respecto#destoutra	respecto#de+esta+outra	S+DFS+IFS0	I
respecto#destoutras	respecto#de+estas+outras	S+DFP+IFP0	I
respecto#destoutro	respecto#de+este+outro	S+DMS+IMS0	I
respecto#destoutros	respecto#de+estes+outros	S+DMP+IMP0	I
respecto#diso	respecto#de+iso	S+DNS	I
respecto#disto	respecto#de+isto	S+DNS	I
respecto#do	respecto#de+o	S+GMS	I
respecto#dos	respecto#de+os	S+GMP	I
respecto#doutra	respecto#de+outra	S+IFS0	I
respecto#doutras	respecto#de+outras	S+IFP0	I
respecto#doutro	respecto#de+outro	S+IMS0	I
respecto#doutros	respecto#de+outros	S+IMP0	I
respecto#dun	respecto#de+un	S+IMS0	I
respecto#dunha	respecto#de+unha	S+IFS0	I
respecto#dunhas	respecto#de+unhas	S+IFP0	I
respecto#duns	respecto#de+uns	S+IMP0	I
riba#da	riba#de+a	S+GFS	I
riba#dalgún	riba#de+algún	S+IMS0	I
riba#dalgúns	riba#de+algúns	S+IMP0	I
riba#dalgunha	riba#de+algunha	S+IFS0	I
riba#dalgunhas	riba#de+algunhas	S+IFP0	I
riba#daquel	riba#de+aquel	S+DMS	I
riba#daquela	riba#de+aquela	S+DFS	I
riba#daquelas	riba#de+aquelas	S+DFP	I
riba#daqueles	riba#de+aqueles	S+DMP	I
riba#daqueloutra	riba#de+aquela+outra	S+DFS+IFS0	I
riba#daqueloutras	riba#de+aquelas+outras	S+DFP+IFP0	I
riba#daqueloutro	riba#de+aquel+outro	S+DMS+IMS0	I
riba#daqueloutros	riba#de+aqueles+outros	S+DMP+IMP0	I
riba#daquilo	riba#de+aquilo	S+DNS	I
riba#das	riba#de+as	S+GFP	I
riba#de	riba#de	S	I
riba#del	riba#de+el	S+P3MSB0	I
riba#dela	riba#de+ela	S+P3FSB0	I
riba#delas	riba#de+elas	S+P3FPB0	I
riba#deles	riba#de+eles	S+P3MPB0	I
riba#desa	riba#de+esa	S+DFS	I
riba#desas	riba#de+esas	S+DFP	I
riba#dese	riba#de+ese	S+DMS	I
riba#deses	riba#de+eses	S+DMP	I
riba#desoutra	riba#de+esa+outra	S+DFS+IFS0	I
riba#desoutras	riba#de+esas+outras	S+DFP+IFP0	I
riba#desoutro	riba#de+ese+outro	S+DMS+IMS0	I
riba#desoutros	riba#de+eses+outros	S+DMP+IMP0	I
riba#desta	riba#de+esta	S+DFS	I
riba#destas	riba#de+estas	S+DFP	I
riba#deste	riba#de+este	S+DMS	I
riba#destes	riba#de+estes	S+DMP	I
riba#destoutra	riba#de+esta+outra	S+DFS+IFS0	I
riba#destoutras	riba#de+estas+outras	S+DFP+IFP0	I
riba#destoutro	riba#de+este+outro	S+DMS+IMS0	I
riba#destoutros	riba#de+estes+outros	S+DMP+IMP0	I
riba#diso	riba#de+iso	S+DNS	I
riba#disto	riba#de+isto	S+DNS	I
riba#do	riba#de+o	S+GMS	I
riba#dos	riba#de+os	S+GMP	I
riba#doutra	riba#de+outra	S+IFS0	I
riba#doutras	riba#de+outras	S+IFP0	I
riba#doutro	riba#de+outro	S+IMS0	I
riba#doutros	riba#de+outros	S+IMP0	I
riba#dun	riba#de+un	S+IMS0	I
riba#dunha	riba#de+unha	S+IFS0	I
riba#dunhas	riba#de+unhas	S+IFP0	I
riba#duns	riba#de+uns	S+IMP0	I
sobre#da	sobre#de+a	S+GFS	I
sobre#dalgún	sobre#de+algún	S+IMS0	I
sobre#dalgúns	sobre#de+algúns	S+IMP0	I
sobre#dalgunha	sobre#de+algunha	S+IFS0	I
sobre#dalgunhas	sobre#de+algunhas	S+IFP0	I
sobre#daquel	sobre#de+aquel	S+DMS	I
sobre#daquela	sobre#de+aquela	S+DFS	I
sobre#daquelas	sobre#de+aquelas	S+DFP	I
sobre#daqueles	sobre#de+aqueles	S+DMP	I
sobre#daqueloutra	sobre#de+aquela+outra	S+DFS+IFS0	I
sobre#daqueloutras	sobre#de+aquelas+outras	S+DFP+IFP0	I
sobre#daqueloutro	sobre#de+aquel+outro	S+DMS+IMS0	I
sobre#daqueloutros	sobre#de+aqueles+outros	S+DMP+IMP0	I
sobre#daquilo	sobre#de+aquilo	S+DNS	I
sobre#das	sobre#de+as	S+GFP	I
sobre#de	sobre#de	S	I
sobre#del	sobre#de+el	S+P3MSB0	I
sobre#dela	sobre#de+ela	S+P3FSB0	I
sobre#delas	sobre#de+elas	S+P3FPB0	I
sobre#deles	sobre#de+eles	S+P3MPB0	I
sobre#desa	sobre#de+esa	S+DFS	I
sobre#desas	sobre#de+esas	S+DFP	I
sobre#dese	sobre#de+ese	S+DMS	I
sobre#deses	sobre#de+eses	S+DMP	I
sobre#desoutra	sobre#de+esa+outra	S+DFS+IFS0	I
sobre#desoutras	sobre#de+esas+outras	S+DFP+IFP0	I
sobre#desoutro	sobre#de+ese+outro	S+DMS+IMS0	I
sobre#desoutros	sobre#de+eses+outros	S+DMP+IMP0	I
sobre#desta	sobre#de+esta	S+DFS	I
sobre#destas	sobre#de+estas	S+DFP	I
sobre#deste	sobre#de+este	S+DMS	I
sobre#destes	sobre#de+estes	S+DMP	I
sobre#destoutra	sobre#de+esta+outra	S+DFS+IFS0	I
sobre#destoutras	sobre#de+estas+outras	S+DFP+IFP0	I
sobre#destoutro	sobre#de+este+outro	S+DMS+IMS0	I
sobre#destoutros	sobre#de+estes+outros	S+DMP+IMP0	I
sobre#diso	sobre#de+iso	S+DNS	I
sobre#disto	sobre#de+isto	S+DNS	I
sobre#do	sobre#de+o	S+GMS	I
sobre#dos	sobre#de+os	S+GMP	I
sobre#doutra	sobre#de+outra	S+IFS0	I
sobre#doutras	sobre#de+outras	S+IFP0	I
sobre#doutro	sobre#de+outro	S+IMS0	I
sobre#doutros	sobre#de+outros	S+IMP0	I
sobre#dun	sobre#de+un	S+IMS0	I
sobre#dunha	sobre#de+unha	S+IFS0	I
sobre#dunhas	sobre#de+unhas	S+IFP0	I
sobre#duns	sobre#de+uns	S+IMP0	I
tocante#á	tocante#a+a	S+GFS	I
tocante#ás	tocante#a+as	S+GFP	I
tocante#ó	tocante#a+o	S+GMS	I
tocante#a	tocante#a	S	I
tocante#ao	tocante#a+o	S+GMS	I
tocante#aos	tocante#a+os	S+GMP	I
tras#da	tras#de+a	S+GFS	I
tras#dalgún	tras#de+algún	S+IMS0	I
tras#dalgúns	tras#de+algúns	S+IMP0	I
tras#dalgunha	tras#de+algunha	S+IFS0	I
tras#dalgunhas	tras#de+algunhas	S+IFP0	I
tras#daquel	tras#de+aquel	S+DMS	I
tras#daquela	tras#de+aquela	S+DFS	I
tras#daquelas	tras#de+aquelas	S+DFP	I
tras#daqueles	tras#de+aqueles	S+DMP	I
tras#daqueloutra	tras#de+aquela+outra	S+DFS+IFS0	I
tras#daqueloutras	tras#de+aquelas+outras	S+DFP+IFP0	I
tras#daqueloutro	tras#de+aquel+outro	S+DMS+IMS0	I
tras#daqueloutros	tras#de+aqueles+outros	S+DMP+IMP0	I
tras#daquilo	tras#de+aquilo	S+DNS	I
tras#das	tras#de+as	S+GFP	I
tras#de	tras#de	S	I
tras#del	tras#de+el	S+P3MSB0	I
tras#dela	tras#de+ela	S+P3FSB0	I
tras#delas	tras#de+elas	S+P3FPB0	I
tras#deles	tras#de+eles	S+P3MPB0	I
tras#desa	tras#de+esa	S+DFS	I
tras#desas	tras#de+esas	S+DFP	I
tras#dese	tras#de+ese	S+DMS	I
tras#deses	tras#de+eses	S+DMP	I
tras#desoutra	tras#de+esa+outra	S+DFS+IFS0	I
tras#desoutras	tras#de+esas+outras	S+DFP+IFP0	I
tras#desoutro	tras#de+ese+outro	S+DMS+IMS0	I
tras#desoutros	tras#de+eses+outros	S+DMP+IMP0	I
tras#desta	tras#de+esta	S+DFS	I
tras#destas	tras#de+estas	S+DFP	I
tras#deste	tras#de+este	S+DMS	I
tras#destes	tras#de+estes	S+DMP	I
tras#destoutra	tras#de+esta+outra	S+DFS+IFS0	I
tras#destoutras	tras#de+estas+outras	S+DFP+IFP0	I
tras#destoutro	tras#de+este+outro	S+DMS+IMS0	I
tras#destoutros	tras#de+estes+outros	S+DMP+IMP0	I
tras#diso	tras#de+iso	S+DNS	I
tras#disto	tras#de+isto	S+DNS	I
tras#do	tras#de+o	S+GMS	I
tras#dos	tras#de+os	S+GMP	I
tras#doutra	tras#de+outra	S+IFS0	I
tras#doutras	tras#de+outras	S+IFP0	I
tras#doutro	tras#de+outro	S+IMS0	I
tras#doutros	tras#de+outros	S+IMP0	I
tras#dun	tras#de+un	S+IMS0	I
tras#dunha	tras#de+unha	S+IFS0	I
tras#dunhas	tras#de+unhas	S+IFP0	I
tras#duns	tras#de+uns	S+IMP0	I
verbo#da	verbo#de+a	S+GFS	I
verbo#dalgún	verbo#de+algún	S+IMS0	I
verbo#dalgúns	verbo#de+algúns	S+IMP0	I
verbo#dalgunha	verbo#de+algunha	S+IFS0	I
verbo#dalgunhas	verbo#de+algunhas	S+IFP0	I
verbo#daquel	verbo#de+aquel	S+DMS	I
verbo#daquela	verbo#de+aquela	S+DFS	I
verbo#daquelas	verbo#de+aquelas	S+DFP	I
verbo#daqueles	verbo#de+aqueles	S+DMP	I
verbo#daqueloutra	verbo#de+aquela+outra	S+DFS+IFS0	I
verbo#daqueloutras	verbo#de+aquelas+outras	S+DFP+IFP0	I
verbo#daqueloutro	verbo#de+aquel+outro	S+DMS+IMS0	I
verbo#daqueloutros	verbo#de+aqueles+outros	S+DMP+IMP0	I
verbo#daquilo	verbo#de+aquilo	S+DNS	I
verbo#das	verbo#de+as	S+GFP	I
verbo#de	verbo#de	S	I
verbo#del	verbo#de+el	S+P3MSB0	I
verbo#dela	verbo#de+ela	S+P3FSB0	I
verbo#delas	verbo#de+elas	S+P3FPB0	I
verbo#deles	verbo#de+eles	S+P3MPB0	I
verbo#desa	verbo#de+esa	S+DFS	I
verbo#desas	verbo#de+esas	S+DFP	I
verbo#dese	verbo#de+ese	S+DMS	I
verbo#deses	verbo#de+eses	S+DMP	I
verbo#desoutra	verbo#de+esa+outra	S+DFS+IFS0	I
verbo#desoutras	verbo#de+esas+outras	S+DFP+IFP0	I
verbo#desoutro	verbo#de+ese+outro	S+DMS+IMS0	I
verbo#desoutros	verbo#de+eses+outros	S+DMP+IMP0	I
verbo#desta	verbo#de+esta	S+DFS	I
verbo#destas	verbo#de+estas	S+DFP	I
verbo#deste	verbo#de+este	S+DMS	I
verbo#destes	verbo#de+estes	S+DMP	I
verbo#destoutra	verbo#de+esta+outra	S+DFS+IFS0	I
verbo#destoutras	verbo#de+estas+outras	S+DFP+IFP0	I
verbo#destoutro	verbo#de+este+outro	S+DMS+IMS0	I
verbo#destoutros	verbo#de+estes+outros	S+DMP+IMP0	I
verbo#diso	verbo#de+iso	S+DNS	I
verbo#disto	verbo#de+isto	S+DNS	I
verbo#do	verbo#de+o	S+GMS	I
verbo#dos	verbo#de+os	S+GMP	I
verbo#doutra	verbo#de+outra	S+IFS0	I
verbo#doutras	verbo#de+outras	S+IFP0	I
verbo#doutro	verbo#de+outro	S+IMS0	I
verbo#doutros	verbo#de+outros	S+IMP0	I
verbo#dun	verbo#de+un	S+IMS0	I
verbo#dunha	verbo#de+unha	S+IFS0	I
verbo#dunhas	verbo#de+unhas	S+IFP0	I
verbo#duns	verbo#de+uns	S+IMP0	I
xunto#á	xunto#a+a	S+GFS	I
xunto#ás	xunto#a+as	S+GFP	I
xunto#ó	xunto#a+o	S+GMS	I
xunto#a	xunto#a	S	I
xunto#ao	xunto#a+o	S+GMS	I
xunto#aos	xunto#a+os	S+GMP	I
xunto#da	xunto#de+a	S+GFS	I
xunto#dalgún	xunto#de+algún	S+IMS0	I
xunto#dalgúns	xunto#de+algúns	S+IMP0	I
xunto#dalgunha	xunto#de+algunha	S+IFS0	I
xunto#dalgunhas	xunto#de+algunhas	S+IFP0	I
xunto#daquel	xunto#de+aquel	S+DMS	I
xunto#daquela	xunto#de+aquela	S+DFS	I
xunto#daquelas	xunto#de+aquelas	S+DFP	I
xunto#daqueles	xunto#de+aqueles	S+DMP	I
xunto#daqueloutra	xunto#de+aquela+outra	S+DFS+IFS0	I
xunto#daqueloutras	xunto#de+aquelas+outras	S+DFP+IFP0	I
xunto#daqueloutro	xunto#de+aquel+outro	S+DMS+IMS0	I
xunto#daqueloutros	xunto#de+aqueles+outros	S+DMP+IMP0	I
xunto#daquilo	xunto#de+aquilo	S+DNS	I
xunto#das	xunto#de+as	S+GFP	I
xunto#de	xunto#de	S	I
xunto#del	xunto#de+el	S+P3MSB0	I
xunto#dela	xunto#de+ela	S+P3FSB0	I
xunto#delas	xunto#de+elas	S+P3FPB0	I
xunto#deles	xunto#de+eles	S+P3MPB0	I
xunto#desa	xunto#de+esa	S+DFS	I
xunto#desas	xunto#de+esas	S+DFP	I
xunto#dese	xunto#de+ese	S+DMS	I
xunto#deses	xunto#de+eses	S+DMP	I
xunto#desoutra	xunto#de+esa+outra	S+DFS+IFS0	I
xunto#desoutras	xunto#de+esas+outras	S+DFP+IFP0	I
xunto#desoutro	xunto#de+ese+outro	S+DMS+IMS0	I
xunto#desoutros	xunto#de+eses+outros	S+DMP+IMP0	I
xunto#desta	xunto#de+esta	S+DFS	I
xunto#destas	xunto#de+estas	S+DFP	I
xunto#deste	xunto#de+este	S+DMS	I
xunto#destes	xunto#de+estes	S+DMP	I
xunto#destoutra	xunto#de+esta+outra	S+DFS+IFS0	I
xunto#destoutras	xunto#de+estas+outras	S+DFP+IFP0	I
xunto#destoutro	xunto#de+este+outro	S+DMS+IMS0	I
xunto#destoutros	xunto#de+estes+outros	S+DMP+IMP0	I
xunto#diso	xunto#de+iso	S+DNS	I
xunto#disto	xunto#de+isto	S+DNS	I
xunto#do	xunto#de+o	S+GMS	I
xunto#dos	xunto#de+os	S+GMP	I
xunto#doutra	xunto#de+outra	S+IFS0	I
xunto#doutras	xunto#de+outras	S+IFP0	I
xunto#doutro	xunto#de+outro	S+IMS0	I
xunto#doutros	xunto#de+outros	S+IMP0	I
xunto#dun	xunto#de+un	S+IMS0	I
xunto#dunha	xunto#de+unha	S+IFS0	I
xunto#dunhas	xunto#de+unhas	S+IFP0	I
xunto#duns	xunto#de+uns	S+IMP0	I
aínda#que	aínda#que	CS	I
a#fin#de#que	a#fin#de#que	CS	I
co#fin#de#que	co#fin#de#que	CS	I
a#menos#que	a#menos#que	CS	I
a#nada#que	a#nada#que	CS	I
a#non#ser#que	a#non#ser#que	CS	I
a#non#ser#se	a#non#ser#se	CS	I
a#pesar#de#que	a#pesar#de#que	CS	I
a#pouco#que	a#pouco#que	CS	I
a#que	a#que	CS	I
agás#que	agás#que	CS	I
agás#se	agás#se	CS	I
aga#que	aga#que	CS	I
aga#se	aga#se	CS	I
agora#ben	agora#ben	CS	I
agora#que	agora#que	CS	I
antes#de#que	antes#de#que	CS	I
antes#que	antes#que	CS	I
así#como	así#como	CS	I
así#e#todo	así#e#todo	CS	I
así#que	así#que	CS	I
até#que	até#que	CS	I
ata#que	ata#que	CS	I
axiña#que	axiña#que	CS	I
bardante#que	bardante#que	CS	I
ben#como	ben#como	CS	I
ben#que	ben#que	CS	I
cada#vez#que	cada#vez#que	CS	I
cando#queira#que	cando#queira#que	CS	I
caso#de#que	caso#de#que	CS	I
coma#se	coma#se	CS	I
como#queira#que	como#queira#que	CS	I
como#se	como#se	CS	I
con#que	con#que	CS	I
con#tal#de#que	con#tal#de#que	CS	I
con#tal#que	con#tal#que	CS	I
con#todo	con#todo	CS	I
dado#que	dado#que	CS	I
de#aí#que	de#aí#que	CS	I
de#forma#que	de#forma#que	CS	I
de#maneira#que	de#maneira#que	CS	I
de#modo#que	de#modo#que	CS	I
de#non#ser#que	de#non#ser#que	CS	I
de#non#ser#se	de#non#ser#se	CS	I
de#xeito#que	de#xeito#que	CS	I
decontado#que	decontado#que	CS	I
deica#que	deica#que	CS	I
dende#que	dende#que	CS	I
des#que	des#que	CS	I
desde#que	desde#que	CS	I
deseguida#que	deseguida#que	CS	I
despois#de#que	despois#de#que	CS	I
despois#que	despois#que	CS	I
e#iso#que	e#iso#que	CS	I
en#canto	en#canto	CS	I
en#caso#de#que	en#caso#de#que	CS	I
en#favor#de#que	en#favor#de#que	CS	I
en#tanto	en#tanto	CS	I
en#troques	en#troques	CS	I
entre#tanto	entre#tanto	CS	I
excepto#que	excepto#que	CS	I
excepto#se	excepto#se	CS	I
fóra#de#que	fóra#de#que	CS	I
inda#ben#non	inda#ben#non	CS	I
inda#que	inda#que	CS	I
logo#de#que	logo#de#que	CS	I
mal#como	mal#como	CS	I
mal#que	mal#que	CS	I
malia#que	malia#que	CS	I
menos#que	menos#que	CS	I
mentres#que	mentres#que	CS	I
mentres#tanto	mentres#tanto	CS	I
mesmo#que	mesmo#que	CS	I
nin#que	nin#que	CS	I
no#entanto	no#entanto	CS	I
non#ben	non#ben	CS	I
non#obstante	non#obstante	CS	I
onde#queira#que	onde#queira#que	CS	I
ora#ben	ora#ben	CS	I
ora#que	ora#que	CS	I
para#que	para#que	CS	I
pois#que	pois#que	CS	I
polo#que	polo#que	CS	I#
polo#tanto	polo#tanto	CS	I
por#causa#de#que	por#causa#de#que	CS	I
por#conseguinte	por#conseguinte	CS	I
por#cousa#de#que	por#cousa#de#que	CS	I
por#culpa#de#que	por#culpa#de#que	CS	I
por#máis#que	por#máis#que	CS	I
por#moito#que	por#moito#que	CS	I
por#mor#de#que	por#mor#de#que	CS	I
por#pouco#que	por#pouco#que	CS	I
por#tanto	por#tanto	CS	I
posto#que	posto#que	CS	I
quitado#que	quitado#que	CS	I
quitado#se	quitado#se	CS	I
quitando#que	quitando#que	CS	I
quitando#se	quitando#se	CS	I
só#que	só#que	CS	I
sacado#que	sacado#que	CS	I
sacado#se	sacado#se	CS	I
sacando#que	sacando#que	CS	I
sacando#se	sacando#se	CS	I
salvo#que	salvo#que	CS	I
salvo#se	salvo#se	CS	I
sempre#que	sempre#que	CS	I
á#vez#que	á#vez#que	CS	I
senón#que	senón#que	CS	I
sen#que	sen#que	CS	I
tal#cal	tal#cal	CS	I
tal#como	tal#como	CS	I
tal#e#como	tal#e#como	CS	I
tan#presto	tan#presto	CS	I
tan#pronto	tan#pronto	CS	I
visto#que	visto#que	CS	I
xa#que	xa#que	CS	I
xa#que#logo	xa#que#logo	CS	I
así#pois	así#pois	CS	I
acerca#de#que	acerca#de#que	CS	I
a#posteriori	a#posteriori	R0	I
a#priori	a#priori	R0	I
a#tergo	a#tergo	R0	I
ab#intestato	ab#intestato	R0	I
ad#libitum	ad#libitum	R0	I
ás#agachadas	ás#agachadas	R0	I
ó#agacho	ó#agacho	R0	I
ao#agacho	ao#agacho	R0	I
por#aí	por#aí	R0	I
de#alí#a#pouco	de#alí#a#pouco	R0	I
de#antemán	de#antemán	R0	I
antes#de#antonte	antes#de#antonte	R0	I
de#aquí#a#pouco	de#aquí#a#pouco	R0	I
así#mesmo	así#mesmo	R0	I
ás#atoutiñadas	ás#atoutiñadas	R0	I
ás#avesas	ás#avesas	R0	I
a#balavento	a#balavento	R0	I
de#balde	de#balde	R0	I
en#balde	en#balde	R0	I
a#baluto	a#baluto	R0	I
de#baluto	de#baluto	R0	I
en#baluto	en#baluto	R0	I
a#baravento	a#baravento	R0	I
ás#baroutas	ás#baroutas	R0	I
a#barullo	a#barullo	R0	I
á#beira	á#beira	R0	I
ó#biés	ó#biés	R0	I
ao#biés	ao#biés	R0	I
ás#boleiradas	ás#boleiradas	R0	I
ós#boleiróns	ós#boleiróns	R0	I
aos#boleiróns	aos#boleiróns	R0	I
ás#borcalladas	ás#borcalladas	R0	I
en#breve	en#breve	R0	I
de#bruzos	de#bruzos	R0	I
ás#cabaleirolas	ás#cabaleirolas	R0	I
ás#cabaliñas	ás#cabaliñas	R0	I
a#cabalo	a#cabalo	R0	I
de#a#cabalo	de#a#cabalo	R0	I
ao#cabo	ao#cabo	R0	I
a#cachapernas	a#cachapernas	R0	I
a#cada#canto	a#cada#canto	R0	I
a#cada#pouco	a#cada#pouco	R0	I
de#camiño	de#camiño	R0	I
de#cando#en#cando	de#cando#en#cando	R0	I
de#cando#en#vez	de#cando#en#vez	R0	I
a#carón	a#carón	R0	I
de#carón	de#carón	R0	I
a#carranchapernas	a#carranchapernas	R0	I
ás#carranchapernas	ás#carranchapernas	R0	I
a#carranchas	a#carranchas	R0	I
ás#carranchas	ás#carranchas	R0	I
ó#carricho	ó#carricho	R0	I
ao#carricho	ao#carricho	R0	I
a#ceacú	a#ceacú	R0	I
á#ceavoga	á#ceavoga	R0	I
ás#cegas	ás#cegas	R0	I
de#certo	de#certo	R0	I
ó#chou	ó#chou	R0	I
ao#chou	ao#chou	R0	I
a#chupe	a#chupe	R0	I
en#conciencia	en#conciencia	R0	I
en#concreto	en#concreto	R0	I
de#contado	de#contado	R0	I
de#contino	de#contino	R0	I
a#contragusto	a#contragusto	R0	I
a#contramán	a#contramán	R0	I
a#contrapelo	a#contrapelo	R0	I
ó#contraxeito	ó#contraxeito	R0	I
ao#contraxeito	ao#contraxeito	R0	I
de#cor	de#cor	R0	I
a#correr	a#correr	R0	I
de#cote	de#cote	R0	I
a#cotío	a#cotío	R0	I
de#cotío	de#cotío	R0	I
de#crequenas	de#crequenas	R0	I
en#crequenas	en#crequenas	R0	I
deica#pouco	deica#pouco	R0	I
deica#un#pouco	deica#un#pouco	R0	I
a#dereitas	a#dereitas	R0	I
ao#dereito	ao#dereito	R0	I
a#desbarate	a#desbarate	R0	I
ao#desbarate	ao#desbarate	R0	I
a#desbarato	a#desbarato	R0	I
ao#desbarato	ao#desbarato	R0	I
a#descomán	a#descomán	R0	I
a#deshora	a#deshora	R0	I
a#destempo	a#destempo	R0	I
en#diante	en#diante	R0	I
a#diario	a#diario	R0	I
a#doután	a#doután	R0	I
a#eito	a#eito	R0	I
á#emborca	á#emborca	R0	I
ás#emborcalladas	ás#emborcalladas	R0	I
a#embute	a#embute	R0	I
de#emprestado	de#emprestado	R0	I
endoutro#día	endoutro#día	R0	I
á#envorca	á#envorca	R0	I
ás#envorcalladas	ás#envorcalladas	R0	I
a#escape	a#escape	R0	I
ás#escondidas	ás#escondidas	R0	I
ás#escuras	ás#escuras	R0	I
a#esgalla	a#esgalla	R0	I
de#esguello	de#esguello	R0	I
ex#aequo	ex#aequo	R0	I
ex#profeso	ex#profeso	R0	I
extra#muros	extra#muros	R0	I
de#face	de#face	R0	I
por#fas	por#fas	R0	I
a#feito	a#feito	R0	I
de#a#feito	de#a#feito	R0	I
á#fin	á#fin	R0	I
ó#fin	ó#fin	R0	I
ao#fin	ao#fin	R0	I
en#fite	en#fite	R0	I
en#fronte	en#fronte	R0	I
de#ganchete	de#ganchete	R0	I
ó#garete	ó#garete	R0	I
ao#garete	ao#garete	R0	I
á#garra	á#garra	R0	I
a#gatiñas	a#gatiñas	R0	I
de#gatiñas	de#gatiñas	R0	I
de#golpe	de#golpe	R0	I
a#granel	a#granel	R0	I
grosso#modo	grosso#modo	R0	I
honoris#causa	honoris#causa	R0	I
hoxe#en#día	hoxe#en#día	R0	I
de#improviso	de#improviso	R0	I
in#albis	in#albis	R0	I
in#extremis	in#extremis	R0	I
in#illo#tempore	in#illo#tempore	R0	I
in#pectore	in#pectore	R0	I
in#situ	in#situ	R0	I
in#vitro	in#vitro	R0	I
in#vivo	in#vivo	R0	I
intra#muros	intra#muros	R0	I
ipso#facto	ipso#facto	R0	I
ó#lado	ó#lado	R0	I
ao#lado	ao#lado	R0	I
lato#sensu	lato#sensu	R0	I
entre#lusco#e#fusco	entre#lusco#e#fusco	R0	I
de#máis	de#máis	R0	I
á#mantenta	á#mantenta	R0	I
a#medias	a#medias	R0	I
ao#mellor	ao#mellor	R0	I
ó#mellor	ó#mellor	R0	I
de#menos	de#menos	R0	I
a#miúdo	a#miúdo	R0	I
polo#miúdo	polo#miúdo	R0	I
de#moca	de#moca	R0	I
a#modo	a#modo	R0	I
de#momento	de#momento	R0	I
motu#proprio	motu#proprio	R0	I
mutatis#mutandis	mutatis#mutandis	R0	I
a#nado	a#nado	R0	I
por#nefas	por#nefas	R0	I
ó#nesgo	ó#nesgo	R0	I
ao#nesgo	ao#nesgo	R0	I
de#oídas	de#oídas	R0	I
o#outro#antonte	o#outro#antonte	R0	I
ó#outro#día	ó#outro#día	R0	I
ao#outro#día	ao#outro#día	R0	I
de#ouvidas	de#ouvidas	R0	I
á#parte	á#parte	R0	I
ó#pé	ó#pé	R0	I
ao#pé	ao#pé	R0	I
a#penas	a#penas	R0	I
per#se	per#se	R0	I
poida#que	poida#que	R0	I
polos#zarapelos	polos#zarapelos	R0	I
en#porrancho	en#porrancho	R0	I
pouco#a#pouco	pouco#a#pouco	R0	I
pouco#e#pouco	pouco#e#pouco	R0	I
ó#pouco	ó#pouco	R0	I
ao#pouco	ao#pouco	R0	I
ós#poucos	ós#poucos	R0	I
aos#poucos	aos#poucos	R0	I
de#poutelas	de#poutelas	R0	I
a#pre	a#pre	R0	I
á#présa	á#présa	R0	I
ás#présas	ás#présas	R0	I
pro#rata	pro#rata	R0	I
de#pronto	de#pronto	R0	I
a#propósito	a#propósito	R0	I
de#propósito	de#propósito	R0	I
a#queimarroupa	a#queimarroupa	R0	I
de#querquena	de#querquena	R0	I
en#querquena	en#querquena	R0	I
en#rama	en#rama	R0	I
ás#rapadas	ás#rapadas	R0	I
de#raro#en#raro	de#raro#en#raro	R0	I
ó#raro	ó#raro	R0	I
ao#raro	ao#raro	R0	I
a#rebolos	a#rebolos	R0	I
a#recú	a#recú	R0	I
de#recú	de#recú	R0	I
ó#redor	ó#redor	R0	I
ao#redor	ao#redor	R0	I
a#rente	a#rente	R0	I
a#rentes	a#rentes	R0	I
a#reo	a#reo	R0	I
de#reollo	de#reollo	R0	I
de#repente	de#repente	R0	I
a#requichas	a#requichas	R0	I
a#retortoiro	a#retortoiro	R0	I
de#riba	de#riba	R0	I
a#rolos	a#rolos	R0	I
a#sabendas	a#sabendas	R0	I
se#cadra	se#cadra	R0	I
se#callar	se#callar	R0	I
de#seguida	de#seguida	R0	I
en#seguida	en#seguida	R0	I
de#seguido	de#seguido	R0	I
sine#die	sine#die	R0	I
sine#qua#non	sine#qua#non	R0	I
de#sobra	de#sobra	R0	I
de#socate	de#socate	R0	I
de#socato	de#socato	R0	I
a#son	a#son	R0	I
stricto#sensu	stricto#sensu	R0	I
sui#generis	sui#generis	R0	I
de#súpeto	de#súpeto	R0	I
tal#vez	tal#vez	R0	I
de#tempo#en#tempo	de#tempo#en#tempo	R0	I
a#tempo	a#tempo	R0	I
en#tempo	en#tempo	R0	I
ás#toas	ás#toas	R0	I
de#todo	de#todo	R0	I
a#través	a#través	R0	I
de#través	de#través	R0	I
a#treo	a#treo	R0	I
do#trinque	do#trinque	R0	I
en#troques	en#troques	R0	I
urbi#et#orbe	urbi#et#orbe	R0	I
de#vagar	de#vagar	R0	I
ás#veces	ás#veces	R0	I
por#veces	por#veces	R0	I
de#vez#en#cando	de#vez#en#cando	R0	I
de#vez	de#vez	R0	I
ás#vorcalladas	ás#vorcalladas	R0	I
ó#xeito	ó#xeito	R0	I
ao#xeito	ao#xeito	R0	I
polos#zarapelos	polos#zarapelos	R0	I
á#zonza	á#zonza	R0	I
a#continuación	a#continuación	R0	I
polo#menos	polo#menos	R0	I
ao#menos	ao#menos	R0	I
ó#menos	ó#menos	R0	I
como#mínimo	como#mínimo	R0	I
como#máximo	como#máximo	R0	I
como#moito	como#moito	R0	I
hoxe#en#día	hoxe#en#día	R0	I
a#longo#prazo	a#longo#prazo	R0	I
a#curto#prazo	a#curto#prazo	R0	I
a#medio#prazo	a#medio#prazo	R0	I
por#unha#banda	por#unha#banda	R0	I
por#outra#banda	por#outra#banda	R0	I
pola#súa#banda	pola#súa#banda	R0	I
por#riba	por#riba	R0	I
polo#xeral	polo#xeral	R0	I
en#xeral	en#xeral	R0	I
ao#mesmo#tempo	ao#mesmo#tempo	R0	I
de#feito	de#feito	R0	I
á#vista	á#vista	R0	I
pola#contra	pola#contra	R0	I
polo#contrario	polo#contrario	R0	I
nin#sequera	nin#sequera	R0	I
en#exceso	en#exceso	R0	I
per#cápita	per#cápita	R0	I
por#suposto	por#suposto	R0	I
ex#situ	ex#situ	R0	I
de#inmediato	de#inmediato	R0	I
a#granel	a#granel	R0	I
ad#hoc	ad#hoc	R0	I
ao#parecer	ao#parecer	R0	I
ante#todo	ante#todo	R0	I
cara#atrás	cara#atrás	R0	I
cara#arriba	cara#arriba	R0	I
cara#abaixo	cara#abaixo	R0	I
e#mais	e#mais	CC	I
e#mailo	e#mais+o	CC+GMS	I
e#mailos	e#mais+os	CC+GMP	I
e#maila	e#mais+a	CC+GFS	I
e#mailas	e#mais+as	CC+GFP	I
a#partir#da	a#partir#de+a	S+GFS	I
a#partir#dalgún	a#partir#de+algún	S+IMS0	I
a#partir#dalgúns	a#partir#de+algúns	S+IMP0	I
a#partir#dalgunha	a#partir#de+algunha	S+IFS0	I
a#partir#dalgunhas	a#partir#de+algunhas	S+IFP0	I
a#partir#daquel	a#partir#de+aquel	S+DMS	I
a#partir#daquela	a#partir#de+aquela	S+DFS	I
a#partir#daquelas	a#partir#de+aquelas	S+DFP	I
a#partir#daqueles	a#partir#de+aqueles	S+DMP	I
a#partir#daqueloutra	a#partir#de+aquela+outra	S+DFS+IFS0	I
a#partir#daqueloutras	a#partir#de+aquelas+outras	S+DFP+IFP0	I
a#partir#daqueloutro	a#partir#de+aquel+outro	S+DMS+IMS0	I
a#partir#daqueloutros	a#partir#de+aqueles+outros	S+DMP+IMP0	I
a#partir#daquilo	a#partir#de+aquilo	S+DNS	I
a#partir#das	a#partir#de+as	S+GFP	I
a#partir#de	a#partir#de	S	I
a#partir#del	a#partir#de+el	S+P3MSB0	I
a#partir#dela	a#partir#de+ela	S+P3FSB0	I
a#partir#delas	a#partir#de+elas	S+P3FPB0	I
a#partir#deles	a#partir#de+eles	S+P3MPB0	I
a#partir#desa	a#partir#de+esa	S+DFS	I
a#partir#desas	a#partir#de+esas	S+DFP	I
a#partir#dese	a#partir#de+ese	S+DMS	I
a#partir#deses	a#partir#de+eses	S+DMP	I
a#partir#desoutra	a#partir#de+esa+outra	S+DFS+IFS0	I
a#partir#desoutras	a#partir#de+esas+outras	S+DFP+IFP0	I
a#partir#desoutro	a#partir#de+ese+outro	S+DMS+IMS0	I
a#partir#desoutros	a#partir#de+eses+outros	S+DMP+IMP0	I
a#partir#desta	a#partir#de+esta	S+DFS	I
a#partir#destas	a#partir#de+estas	S+DFP	I
a#partir#deste	a#partir#de+este	S+DMS	I
a#partir#destes	a#partir#de+estes	S+DMP	I
a#partir#destoutra	a#partir#de+esta+outra	S+DFS+IFS0	I
a#partir#destoutras	a#partir#de+estas+outras	S+DFP+IFP0	I
a#partir#destoutro	a#partir#de+este+outro	S+DMS+IMS0	I
a#partir#destoutros	a#partir#de+estes+outros	S+DMP+IMP0	I
a#partir#diso	a#partir#de+iso	S+DNS	I
a#partir#disto	a#partir#de+isto	S+DNS	I
a#partir#do	a#partir#de+o	S+GMS	I
a#partir#dos	a#partir#de+os	S+GMP	I
a#partir#doutra	a#partir#de+outra	S+IFS0	I
a#partir#doutras	a#partir#de+outras	S+IFP0	I
a#partir#doutro	a#partir#de+outro	S+IMS0	I
a#partir#doutros	a#partir#de+outros	S+IMP0	I
a#partir#dun	a#partir#de+un	S+IMS0	I
a#partir#dunha	a#partir#de+unha	S+IFS0	I
a#partir#dunhas	a#partir#de+unhas	S+IFP0	I
a#partir#duns	a#partir#de+uns	S+IMP0	I
logo#da	logo#de+a	S+GFS	I
logo#dalgún	logo#de+algún	S+IMS0	I
logo#dalgúns	logo#de+algúns	S+IMP0	I
logo#dalgunha	logo#de+algunha	S+IFS0	I
logo#dalgunhas	logo#de+algunhas	S+IFP0	I
logo#daquel	logo#de+aquel	S+DMS	I
logo#daquela	logo#de+aquela	S+DFS	I
logo#daquelas	logo#de+aquelas	S+DFP	I
logo#daqueles	logo#de+aqueles	S+DMP	I
logo#daqueloutra	logo#de+aquela+outra	S+DFS+IFS0	I
logo#daqueloutras	logo#de+aquelas+outras	S+DFP+IFP0	I
logo#daqueloutro	logo#de+aquel+outro	S+DMS+IMS0	I
logo#daqueloutros	logo#de+aqueles+outros	S+DMP+IMP0	I
logo#daquilo	logo#de+aquilo	S+DNS	I
logo#das	logo#de+as	S+GFP	I
logo#de	logo#de	S	I
logo#del	logo#de+el	S+P3MSB0	I
logo#dela	logo#de+ela	S+P3FSB0	I
logo#delas	logo#de+elas	S+P3FPB0	I
logo#deles	logo#de+eles	S+P3MPB0	I
logo#desa	logo#de+esa	S+DFS	I
logo#desas	logo#de+esas	S+DFP	I
logo#dese	logo#de+ese	S+DMS	I
logo#deses	logo#de+eses	S+DMP	I
logo#desoutra	logo#de+esa+outra	S+DFS+IFS0	I
logo#desoutras	logo#de+esas+outras	S+DFP+IFP0	I
logo#desoutro	logo#de+ese+outro	S+DMS+IMS0	I
logo#desoutros	logo#de+eses+outros	S+DMP+IMP0	I
logo#desta	logo#de+esta	S+DFS	I
logo#destas	logo#de+estas	S+DFP	I
logo#deste	logo#de+este	S+DMS	I
logo#destes	logo#de+estes	S+DMP	I
logo#destoutra	logo#de+esta+outra	S+DFS+IFS0	I
logo#destoutras	logo#de+estas+outras	S+DFP+IFP0	I
logo#destoutro	logo#de+este+outro	S+DMS+IMS0	I
logo#destoutros	logo#de+estes+outros	S+DMP+IMP0	I
logo#diso	logo#de+iso	S+DNS	I
logo#disto	logo#de+isto	S+DNS	I
logo#do	logo#de+o	S+GMS	I
logo#dos	logo#de+os	S+GMP	I
logo#doutra	logo#de+outra	S+IFS0	I
logo#doutras	logo#de+outras	S+IFP0	I
logo#doutro	logo#de+outro	S+IMS0	I
logo#doutros	logo#de+outros	S+IMP0	I
logo#dun	logo#de+un	S+IMS0	I
logo#dunha	logo#de+unha	S+IFS0	I
logo#dunhas	logo#de+unhas	S+IFP0	I
logo#duns	logo#de+uns	S+IMP0	I
a#favor#da	a#favor#de+a	S+GFS	I
a#favor#dalgún	a#favor#de+algún	S+IMS0	I
a#favor#dalgúns	a#favor#de+algúns	S+IMP0	I
a#favor#dalgunha	a#favor#de+algunha	S+IFS0	I
a#favor#dalgunhas	a#favor#de+algunhas	S+IFP0	I
a#favor#daquel	a#favor#de+aquel	S+DMS	I
a#favor#daquela	a#favor#de+aquela	S+DFS	I
a#favor#daquelas	a#favor#de+aquelas	S+DFP	I
a#favor#daqueles	a#favor#de+aqueles	S+DMP	I
a#favor#daqueloutra	a#favor#de+aquela+outra	S+DFS+IFS0	I
a#favor#daqueloutras	a#favor#de+aquelas+outras	S+DFP+IFP0	I
a#favor#daqueloutro	a#favor#de+aquel+outro	S+DMS+IMS0	I
a#favor#daqueloutros	a#favor#de+aqueles+outros	S+DMP+IMP0	I
a#favor#daquilo	a#favor#de+aquilo	S+DNS	I
a#favor#das	a#favor#de+as	S+GFP	I
a#favor#de	a#favor#de	S	I
a#favor#del	a#favor#de+el	S+P3MSB0	I
a#favor#dela	a#favor#de+ela	S+P3FSB0	I
a#favor#delas	a#favor#de+elas	S+P3FPB0	I
a#favor#deles	a#favor#de+eles	S+P3MPB0	I
a#favor#desa	a#favor#de+esa	S+DFS	I
a#favor#desas	a#favor#de+esas	S+DFP	I
a#favor#dese	a#favor#de+ese	S+DMS	I
a#favor#deses	a#favor#de+eses	S+DMP	I
a#favor#desoutra	a#favor#de+esa+outra	S+DFS+IFS0	I
a#favor#desoutras	a#favor#de+esas+outras	S+DFP+IFP0	I
a#favor#desoutro	a#favor#de+ese+outro	S+DMS+IMS0	I
a#favor#desoutros	a#favor#de+eses+outros	S+DMP+IMP0	I
a#favor#desta	a#favor#de+esta	S+DFS	I
a#favor#destas	a#favor#de+estas	S+DFP	I
a#favor#deste	a#favor#de+este	S+DMS	I
a#favor#destes	a#favor#de+estes	S+DMP	I
a#favor#destoutra	a#favor#de+esta+outra	S+DFS+IFS0	I
a#favor#destoutras	a#favor#de+estas+outras	S+DFP+IFP0	I
a#favor#destoutro	a#favor#de+este+outro	S+DMS+IMS0	I
a#favor#destoutros	a#favor#de+estes+outros	S+DMP+IMP0	I
a#favor#diso	a#favor#de+iso	S+DNS	I
a#favor#disto	a#favor#de+isto	S+DNS	I
a#favor#do	a#favor#de+o	S+GMS	I
a#favor#dos	a#favor#de+os	S+GMP	I
a#favor#doutra	a#favor#de+outra	S+IFS0	I
a#favor#doutras	a#favor#de+outras	S+IFP0	I
a#favor#doutro	a#favor#de+outro	S+IMS0	I
a#favor#doutros	a#favor#de+outros	S+IMP0	I
a#favor#dun	a#favor#de+un	S+IMS0	I
a#favor#dunha	a#favor#de+unha	S+IFS0	I
a#favor#dunhas	a#favor#de+unhas	S+IFP0	I
a#favor#duns	a#favor#de+uns	S+IMP0	I
xunto#co	xunto#con+o	S+GMS	I
xunto#coa	xunto#con+a	S+GFS	I
xunto#coas	xunto#con+as	S+GFP	I
xunto#con	xunto#con	S	I
xunto#cos	xunto#con+os	S+GMP	I
xunto#cun	xunto#con+un	S+IMS0	I
xunto#cunha	xunto#con+unha	S+IFS0	I
xunto#cunhas	xunto#con+unhas+IFP0	S	I
xunto#cuns	xunto#con+uns	S+IMP0	I
grazas#á	grazas#a+a	S+GFS	I
grazas#ás	grazas#a+as	S+GFP	I
grazas#ó	grazas#a+o	S+GMS	I
grazas#a	grazas#a	S	I
grazas#ao	grazas#a+o	S+GMS	I
grazas#aos	grazas#a+os	S+GMP	I
de#acordo#co	de#acordo#con+o	S+GMS	I
de#acordo#coa	de#acordo#con+a	S+GFS	I
de#acordo#coas	de#acordo#con+as	S+GFP	I
de#acordo#con	de#acordo#con	S	I
de#acordo#cos	de#acordo#con+os	S+GMP	I
de#acordo#cun	de#acordo#con+un	S+IMS0	I
de#acordo#cunha	de#acordo#con+unha	S+IFS0	I
de#acordo#cunhas	de#acordo#con+unhas+IFP0	S	I
de#acordo#cuns	de#acordo#con+uns	S+IMP0	I